encyclopedia|NN jump|NN navigation|NN jump|NN search|NN pityriasis_rosea|DS name|NN pityriasis_rosea|DS pityriasis_rosea|DS back|NN disease|NN symptom|NN red|NN area|NN onset|NN year|NN duration|NN month|NN cause|NN method|NN symptom|NN diagnosis|NN rash|ST eczema|NN treatment|NN care|NN frequency|NN point|NN time|NN 
pityriasis_rosea|DS type|NN skin|NN rash|ST red|NN area|NN herald|NN patch|NN day|NN week|NN body|NN rash|ST month|NN treatment|NN fever|ST start|NN rash|ST symptom|NN 
cause|NN herpesvirus|NN herpesvirus|NN medication|NN rash|ST diagnosis|NN symptom|NN 
evidence|NN treatment|NN people|NN point|NN time|NN age|NN condition|NN content|NN 
sign|NN symptom|NN cause|NN diagnosis|NN treatment|NN epidemiology|NN reference|NN link|NN 
sign|NN symptom|NN pityriasis_rosea|DS torso|NN 
symptom|NN condition|NN 
tract|NN infection|NN symptom|NN patient|NN herald|NN patch|NN abdomen|NN herald|NN patch|NN position|NN armpit|NN example|NN 
herald|NN patch|NN cluster|NN spot|NN acne|DS 
present|NN day|NN herald|NN patch|NN rash|ST torso|NN 
chest|NN characteristic|NN distribution|NN 
back|NN neck|NN day|NN case|NN distribution|NN rash|ST extremity|NN children|NN presentation|NN course|NN people|NN itch|ST 
itch|ST skin|NN over-dryness|NN soap|NN area|NN 
rash|ST course|NN disease|NN rash|ST fever|ST headache|ST nausea|ST fatigue|ST 
cause|NN pityriasis_rosea|DS presentation|NN immunologic|NN reaction|NN infection|NN cause|NN 
reactivation|NN cause|NN infant|NN diagnosis|NN herald|NN patch|NN pityriasis_rosea|DS rest|NN lesion|NN infection|NN 
practitioner|NN diagnosis|NN diagnosis|NN doubt|NN test|NN rule|NN condition|NN lyme_disease|DS ringworm|NN psoriasis|NN eczema|NN drug|NN eruption|NN exanthem|NN appearance|NN pityriasis_rosea|DS syphilis|DS plasma|NN test|NN concern|NN syphilis|DS biopsy|NN lesion|NN erythrocyte|NN papillae|NN cell|NN dermis|NN 
set|NN criteria|NN pityriasis_rosea|DS 
patient|NN pityriasis_rosea|DS 
occasion|NN encounter|NN feature|NN feature|NN occasion|NN encounter|NN rash|ST feature|NN 
circular|NN lesion|NN lesion|NN scale|NN clearance|NN lesion|NN 
limb|NN distribution|NN lesion|NN orientation|NN lesion|NN skin|NN cleavage|NN line|NN herald|NN patch|NN appear|NN day|NN eruption|NN lesion|NN history|NN patient|NN observation|NN 
vesicle|NN lesion|NN lesion|NN palmar|NN skin|NN surface|NN evidence|NN syphilis|DS 
condition|NN treatment|NN steroid|NN decrease|NN itch|ST relief|NN itch|ST appearance|NN rash|ST skin|NN form|NN rash|ST skin|NN color|NN 
scare|NN scratch|NN 
scratch|NN cycle|NN scratch|NN itch|ST 
soap|NN fragrance|NN water|NN wool|NN fabrics|NN 
help|NN stop|NN itch|ST 
sunlight|NN lesion|NN principle|NN treatment|NN light|NN resolution|NN study|NN itch|ST therapy|NN week|NN eruption|NN 
meta-analysis|NN evidence|NN effectiveness|NN treatment|NN rash|ST itch|ST trial|NN study|NN result|NN 
patient|NN condition|NN matter|NN week|NN case|NN month|NN 
disease|NN effect|NN 
percent|NN patient|NN recurrence|NN epidemiology|NN 
prevalence|NN united|NN states|NN men|NN women|NN 
age|NN spring|NN 
report|NN epidemics|NN fraternity|NN house|NN base|NN school|NN gym|NN 
form|NN pityriasis_rosea|DS axillae|NN groin|NN pityriasis|NN list|NN skin|NN condition|NN list|NN condition|NN 
