syndrome|NN syndrome|NN syndrome|NN external resource|NN icd-9|NN syndrome|NN syndrome|NN condition|NN cause chromosome|NN male|NN affect individual|NN pair|NN sex|NN chromosome|NN instead associate additional risk|NN medical condition|NN
name dr|NP
harry|NP klinefelter medical researcher|NN massachusetts|NP general hospital|NN boston|NP massachusetts|NP describe condition|NN condition|NN exist roughly male|NN content|NN sign|NN symptom|NN cause|NN treatment|NN variation|NN reference|NN see external link|NN edit sign|NN symptom|NN affect male|NN alway sterile degree|NN language|NN impairment|NN present
adult|NN possible characteristics|NN vary widely include little sign|NN affectedness|NN lanky youthful build|NN facial appearance|NN round body|NN type|NN degree|NN increase breast|NN tissue|NN
gynecomastia extent|NN present individual|NN affect higher percentage|NN population|NN
far end|NN spectrum|NN associate increase risk|NN breast|NN cancer|NN pulmonary disease|NN varicose vein|NN diabete|NN mellitus|NN rheumatoid arthritis|NN osteoporosis|NN risk|NN share women|NN
rare recessive problem|NN occur even infrequently male|NN condition|NN transmit gene|NN chromosome|NN people|NN chromosome|NN typically carrier|NN affect
variance|NN xxy population|NN like 46xy population|NN
possible characterise male|NN certain body|NN type|NN method|NN identification|NN 47xxy
method|NN identification|NN test|NN
edit|NN cause|NN xxy chromosome|NN arrangement|NN common genetic variation|NN occure live male birth|NN
citation|NN need extra chromosome|NN individual|NN condition|NN usually refer male|NN 47xxy male|NN suffer|NN syndrome|NN
mammal|NN chromosome|NN gene|NN chromosome|NN bare express
happen male|NN well female|NN
gene|NN correspond gene|NN y|NP chromosome|NN bare
triploid gene|NN xxy male|NN responsible symptom|NN associate syndrome|NN
publish report|NN man|NN 47xxy karyotype|NN patricia|NP
jacobs|NP dr|NP
strong western general hospital|NN edinburgh|NP scotland|NP found 24-year-old man|NN sign|NN syndrome|NN
jacobs|NP describe discovery|NN report human|NN mammalian chromosome|NN aneuploidy|NN william|NP allan|NP memorial|NN award|NN address|NN edit|NN treatment|NN condition|NN irreversible symptom|NN alter number|NN way|NN testosterone|NN treatment|NN therapy|NN
gender|NN identity|NN people|NN karyotype|NN generally stable seem people|NN klinefelter|NN suffer gender|NN identity|NN disorder|NN people|NN
observation|NN base report|NN support|NN group|NN transgender|NN transsexual people|NN scientific study|NN subject|NN
fact|NN person|NN undergo treatment|NN gender|NN identity|NN disorder|NN syndrome|NN miss patient|NN told jurisdiction|NN additional diagnosis|NN legal consequence|NN example|NN name|NN change|NN medical treatment|NN adapt
treate syndrome|NN increase|NN recognize psychosocial morbidity|NN
need|NN prospectively plan time support|NN young men|NN syndrome|NN ameliorate current poor psychosocial outcome|NN alternative|NN testosterone|NN treatment|NN include daily regime|NN cardiovascular exercise|NN complete soy diet|NN regular vitamin|NN herb|NN
weight|NN bear|NN exercise|NN create muscle|NN edit variation|NN xxyy male|NN syndrome|NN occur birth|NN traditionally consider variation|NN syndrome|NN
longer generally consider variation|NN ks|NP assign icd-9 code|NN
male|NN syndrome|NN mosaic|NN constitutional karyotype|NN vary degree|NN failure|NN
47xxy46xx|NN clinical feature|NN suggestive syndrome|NN rare
far case|NN describe literature|NN edit|NN reference|NN
klinefelter|NP hf|NP jr|NP ec|NP jr|NP albright|NP
syndrome|NN characterize aspermatogenesis|NN a-leydigism|NN increase excretion|NN hormone|NN
j|NP clin|NP metab|NP 19422615-624|NP
syndrome|NN national institute|NN child|NN health|NN mental development|NN
jacobs|NP pa|NN strong|NP ja|NP
case|NN human intersexuality|NN possible xxy|NN mechanism|NN
nature|NN jan|NP
jacobs|NP pa|NN
william|NP allan|NP memorial|NN award|NN address|NN human population|NN year|NN
am|NP j|NP hum|NP genet|NP
simm|NP pj|NP
psychosocial impact|NN klinefelter|NN year|NN review|NN
j|NP pediatr|NP endocrinol|NP
velissariou|NP v|NP s|NP c|NP kanaka-gantenbein c|NP n|NP g|NP
rare xxyxx|NN phenotypic male|NN syndrome|NN case|NN report|NN
eur|NP j|NP med|NP genet|NP july|NP august494331-337|NP
16829354 edit|NN see turner|NP syndrome|NN syndrome|NN triple syndrome|NN syndrome|NN edit|NN external link|NN national institute|NN child|NN health|NN xxytalk|NN global support|NN group|NN syndrome|NN syndrome|NN associate|NN american association|NN syndrome|NN information|NN support|NN detail 7587 data|NN austria|NP syndrom|NP groupe|NP information|NN support|NN syndrome|NN project|NN
arta1uhtml text|NN come free encyclopedia|NN
permission|NN grant copy|NN distribute modify document|NN term|NN gnu free documentation|NN version|NN later version|NN publish free software|NN foundation|NN invariant section|NN front-cover text|NN back-cover text|NN
complete list|NN contributor|NN give article|NN visit|NN correspond entry|NN english wikipedia|NN click|NN history|NN
detail|NN license|NN image|NN visit|NN correspond entry|NN english wikipedia|NN click|NN picture|NN
