syndrome|NN syndrome|NN syndrome|NN external resource|NN icd-9|NN 608638|NN medlineplus 001549|NN asperger syndrome|NN refer syndrome|NN neurobiological|NN pervasive developmental disorder|NN characterize deficiency|NN social communication|NN skill|NN
consider part|NN autistic spectrum|NN
syndrome|NN differentiate pdd|NN high function|NN autism|NN early development|NN normal language|NN delay|NN
possible people|NN learn|NN disability|NN concurrently syndrome|NN
case|NN differential diagnosis|NN essential identify subsequent support|NN requirement|NN
conversely iq|NN test|NN show normal superior intelligence|NN standard|NN language|NN development|NN compare delay|NN typical classic autism|NN
diagnosis|NN complicate lack|NN adoption|NN standardize diagnostic screen|NN use|NN different screen|NN instrument|NN set|NN diagnostic criteria|NN
exact cause|NN unknown prevalence|NN firmly establish partly use|NN differ set|NN diagnostic criteria|NN
syndrome|NN name honor|NN hans|NP asperger|NP austrian psychiatrist|NN pediatrician|NN researcher|NN lorna|NP wing|NP use eponym|NN paper|NN recognize edition|NN diagnostic statistical manual|NN mental disorder|NN disorder|NN identify early childhood|NN individual|NN receive diagnosis|NN puberty|NN adult|NN
assistance|NN core|NN symptom|NN consist therapy|NN apply behavior|NN management|NN strategy|NN address|NN poor communication|NN skill|NN obsessive repetitive routine|NN physical clumsiness|NN
individual|NN adopt strategy|NN cope|NN lead fulfil live|NN gainfully employ get marry successful relationship|NN family|NN
case|NN aware difference|NN recognize need support maintain independent life|NN content|NN classification|NN diagnosis|NN characteristics|NN social difference|NN speech|NN language|NN difference|NN narrow intense interest|NN difference|NN history|NN clinical perspective|NN research|NN research|NN cause|NN research|NN treatment|NN epidemiology|NN perspective|NN shift|NN view|NN culture|NN social impact|NN adult|NN parent|NN notable case|NN see note|NN external link|NN edit classification|NN diagnosis|NN correlate|NN disorder|NN define section|NN 29980|NN diagnostic statistical manual|NN mental disorder|NN main criteria|NN
criteria|NN define condition|NN qualitative impairment|NN social interaction|NN presence|NN restrict repetitive stereotype behavior|NN interest|NN significant impairment|NN important area|NN function significant delay|NN language|NN year|NN life|NN clinically significant delay|NN cognitive development|NN curiosity|NN exist environment|NN acquisition|NN age|NN appropriate learn|NN skill|NN self-help skill|NN adaptive social interaction|NN symptom|NN better account specific pervasive developmental disorder|NN schizophrenia|NN autism|NN spectrum|NN disorder|NN neurological condition|NN characterize difference|NN language|NN communication|NN skill|NN well repetitive restrictive pattern|NN thought|NN behavior|NN
relate disorder|NN condition|NN autism rett syndrome|NN childhood|NN disorder|NN pervasive developmental disorder|NN otherwise specify diagnosis|NN complicate use|NN different screen|NN instrument|NN diagnostic criteria|NN diagnostic statistical manual|NN criticize vague subjective set|NN diagnostic criteria|NN icd|NP world|NN health|NN organization|NN diagnostic criteria|NN diagnostic criteria|NN diagnostic criteria|NN attwood|NP gray|NP discovery|NN criteria|NN icd-10 definition|NN similar criteria|NN dsm-iv version|NN syndrome|NN different time|NN call psychopathy|NN disorder|NN childhood|NN term|NN understood archaic inaccurate therefore longer accept common use|NN
doctor|NN believe separate distinct disorder|NN refer high function|NN autism|NN diagnose|NN use interchangeably complicate prevalence|NN estimate child|NN receive different diagnose|NN depend screen|NN tool|NN doctor|NN use|NN children|NN diagnose instead vice experience clinician|NN apply early onset|NN high function|NN regressive pattern|NN development|NN distinguish factor|NN differentiate hfa
current classification|NN pervasive developmental disorder|NN unsatisfy parent|NN clinician|NN researcher|NN reflect true nature|NN condition|NN peter|NP canadian researcher|NN pdd|NN feel greater precision|NN need better differentiate various pdd|NN diagnose|NN
dsm-iv|NN focus|NN idea|NN discrete biological entity|NN exist pdd|NN lead preoccupation|NN search cross-sectional difference|NN pdd subtype|NN recognition|NN condition|NN distinct point|NN spectrum|NN strategy|NN useful classification|NN clinical practice|NN edit|NN characteristics|NN characterize narrow interest|NN preoccupation|NN subject|NN exclusion|NN activity|NN behavior|NN ritual|NN speech|NN language|NN extensive logicaltechnical|NN pattern|NN thought|NN compare personality|NN trait|NN popular star|NN trek|NN character|NN spock|NP socially emotionally inappropriate behavior|NN interpersonal interaction|NN problem|NN communication|NN uncoordinate motor|NN movement|NN
common important characteristics|NN divide broad category|NN social impairment|NN narrow intense interest|NN peculiarity|NN speech|NN language|NN
feature|NN commonly associate syndrome|NN alway regard necessary diagnosis|NN
section|NN mainly reflect view|NN attwood|NP wing|NN important characteristics|NN dsm-iv criteria|NN represent slightly different view|NN
form|NN pdd|NN camouflage people|NN disorder|NN blend|NN
effect|NN depend affect individual|NN respond syndrome|NN edit social difference|NN single feature|NN people|NN share|NN difficulty|NN social behavior|NN nearly universal important define criteria|NN
people|NN lack|NN natural ability|NN see subtext|NN social interaction|NN lack ability|NN communicate emotional state|NN result well-mean remark|NN offend find hard know acceptable
unwritten rule|NN social behavior|NN mystify term hidden curriculum|NN people|NN learn social skill|NN intellectually seemingly contrive dry math-like|NN logic|NN intuitively normal emotional interaction|NN able gather information|NN people|NN cognitive emotional state|NN base clue|NN glean environment|NN people|NN facial expression|NN body|NN language|NN respect|NN people|NN impair sometime call mind-blindness|NN known lack|NN theory|NN mind|NN theory|NN mind|NN individual|NN lack ability|NN recognize understand thought|NN feel|NN
deprive insightful information|NN unable interpret understand desire|NN intention|NN thereby unable predict expect expect
lead social awkwardness|NN inappropriate behavior|NN
syndrome|NN school|NN clinics|NN community|NN tony|NP attwood|NP way|NN lack|NN theory|NN mind|NN negatively impact social interaction|NN people|NN difficulty|NN read social emotional message|NN eye|NN people|NN look|NN eye|NN cant|NN read
make literal interpretation|NN individual|NN trouble|NN sarcasm|NN metaphor|NN
consider disrespectful rude egocentric behavior|NN individual|NN miss|NN cue|NN warn|NN sign|NN behavior|NN inappropriate
honesty|NN deception|NN children|NN asperger|NN consider honest difficulty|NN deceptive even expense|NN hurt feel|NN
becom aware make social error|NN children|NN mature become aware mindblindness|NN fear|NN make social mistake|NN self-criticism|NN lead social phobia|NN
sense|NN paranoia|NN mindblindness person|NN aspergers|NP trouble|NN distinguish difference|NN deliberate accidental action|NN turn|NN lead|NN feel|NN paranoia|NN
manage conflict|NN unable understand point|NN view|NN lead inflexibility|NN inability|NN negotiate conflict|NN resolution|NN
conflict|NN resolve remorse|NN evident
awareness|NN hurt feel|NN lack|NN empathy|NN lead unintentionally offensive insensitive behavior|NN
repair feel|NN lack intuition|NN feel|NN people|NN little understand|NN console make feel better
recognize sign|NN boredom|NN inability|NN understand people|NN interest|NN lead person|NN inattentive
conversely people|NN fail notice uninterest
self-consciousness|NN individual|NN difficulty|NN understand feel|NN impact|NN feel|NN people|NN
cloth|NN personal hygiene|NN people|NN unaffect peer|NN pressure|NN
result|NN comfortable unconcern impact|NN
reciprocal love|NN grief|NN people|NN react practically emotionally expression|NN affection|NN grief|NN short weak
understand|NN embarrassment|NN faux|NN pa|NN person|NN intellectual understand|NN embarrassment|NN faux|NN unable grasp concept|NN emotional level|NN
cope criticism|NN people|NN compel correct mistake|NN even made position|NN authority|NN teacher|NN
reason|NN unwittingly offensive
speed|NN quality|NN social process|NN respond reason|NN intuition|NN individual|NN tend process social information|NN slowly norm|NN lead uncomfortable pause|NN delay|NN response|NN
exhaustion people|NN begin understand theory|NN mind|NN make deliberate effort|NN process|NN social information|NN
lead mental exhaustion|NN
person|NN trouble|NN understand emotion|NN people|NN message|NN convey facial expression|NN eye|NN contact|NN body|NN language|NN miss
trouble|NN show empathy|NN people|NN
people|NN seen egotistical selfish uncare
case|NN unfair label|NN affect people|NN neurologically unable understand people|NN emotional state|NN
usually shock upset|NN remorseful told action|NN hurtful inappropriate
clear people|NN lack emotion|NN
concrete nature|NN emotional attachment|NN ie object|NN people|NN seem curious even cause|NN concern|NN people|NN share perspective|NN problem|NN exacerbate response|NN neurotypical people|NN interact person|NN
asperger patient|NN apparent emotional detachment|NN confuse upset neurotypical person|NN turn|NN react illogically emotionally reaction|NN asperger patient|NN find especially irritate
become vicious cycle|NN sometime cause family|NN asperger-affect member|NN become especially dysfunctional
fail show affection|NN fail conventional way|NN necessarily mean people|NN feel affection|NN
understand lead partner|NN care-giver|NN feel reject understand|NN
increase understand|NN come learn|NN comorbid disorder|NN sometime opposite problem|NN occur person|NN unusually affectionate significant miss|NN misinterpret signal|NN partner|NN cause partner|NN stress|NN important aspect|NN social difference|NN found people|NN asperger|NN lack|NN central coherence|NN people|NN poor central coherence|NN focuse detail|NN miss big picture|NN
person|NN central coherence|NN deficit|NN remember story|NN incident|NN great detail|NN unable make statement|NN detail|NN mean
understand set|NN rule|NN detail|NN unclear apply
frith|NP happe|NP explore possibility|NN attention|NN detail|NN bia|NN deficit|NN
certainly appear advantage|NN detail|NN orient particularly activity|NN profession|NN require high level|NN
see cause problem|NN certainly people|NN able move detail|NN big picture|NN orientation|NN
edit|NN speech|NN language|NN difference|NN people|NN typically highly pedantic way|NN speak|NN use far formal language|NN register|NN appropriate context|NN
five-year-old|NN child|NN condition|NN regularly speak language|NN easily come university|NN textbook|NN especially special area|NN interest|NN interpretation|NN common universal hallmark|NN condition|NN
attwood|NP give example|NN girl|NN answer telephone|NN day|NN ask paul|NP
paul|NP question|NN house|NN room|NN look ascertain simply said hung
person|NN end|NN call back explain meant find get pick telephone|NN individual|NN use word|NN new coinage|NN unusual juxtaposition|NN
develop rare gift|NN especially pun|NN doggerel|NN satire|NN
potential source|NN humor|NN eventual realization|NN literal interpretation|NN use amuse
proficient written language|NN qualify
tony|NP attwood|NP refer particular child|NN skill|NN invent expression|NN eg tidy opposite|NN tidy broken refer baby|NN brother|NN walk talk children|NN show advance ability|NN age|NN language|NN read|NN mathematics|NN spatial skill|NN music|NN sometime gift range|NN talent|NN counterbalance appreciable delay|NN development|NN cognitive function|NN typical behavior|NN echolalia repetition|NN echo|NN verbal utterance|NN made person|NN palilalia repetition|NN word|NN study|NN investigate written language|NN children|NN youth|NN
compare neurotypical peer|NN standardize test|NN written language|NN skill|NN legibility|NN handwrit|NN
written language|NN skill|NN significant difference|NN found standardize score|NN group|NN skill|NN participant|NN produce significantly legible letter|NN word|NN neurotypical group|NN
analysis|NN written sample|NN text|NN found people|NN produce similar quantity|NN text|NN neurotypical peer|NN difficulty|NN produce write|NN quality|NN tony|NP attwood|NP state teacher|NN spend considerable time|NN interpret|NN correct child indecipherable scrawl|NN
child|NN aware poor quality|NN handwrit|NN reluctant engage activity|NN involve extensive write|NN
unfortunately children|NN adult|NN high school|NN teacher|NN prospective employer|NN consider neatness|NN handwrit|NN measure|NN intelligence|NN personality|NN
child|NN require assessment|NN occupational therapist|NN remedial exercise|NN modern technology|NN help minimize problem|NN
parent|NN teacher|NN aide|NN act child scribe|NN proofreader|NN ensure legibility|NN child written answer|NN homework|NN edit|NN narrow intense interest|NN children|NN involve intense obsessive level|NN focus|NN thing|NN interest|NN ordinary children|NN
difference|NN children|NN unusual intensity|NN said interest|NN suggest obsession|NN essentially arbitrary lack real mean|NN context|NN recent research|NN suggest isnt|NN usually case|NN sometime interest|NN lifelong case|NN change unpredictable interval|NN
case|NN normally interest|NN give time|NN
pursuit|NN interest|NN people|NN manifest extremely sophisticate reason|NN obsessive focus|NN remarkably good memory|NN trivial fact|NN occasionally even eidetic memory|NN hans|NP asperger|NP call young patient|NN little professor|NN thought patient|NN comprehensive nuance understand|NN field|NN interest|NN university|NN professor|NN clinician|NN entirely agree description|NN
example|NN wing|NN gillberg argue children|NN area|NN intense interest|NN typically involve rote|NN real understand|NN occasional appearance|NN contrary|NN
limitation|NN artifact|NN diagnostic criteria|NN even criteria|NN people|NN little patience|NN thing|NN narrow interest|NN
school|NN perceive highly intelligent overachiever clearly capable outperform peer|NN field|NN interest|NN persistently unmotivate regular homework|NN assignment|NN sometime even area|NN interest|NN
hypermotivate outperform peer|NN school|NN
combination|NN social problem|NN intense interest|NN lead unusual behavior|NN greet stranger|NN launch|NN lengthy monologue|NN special interest|NN introduce socially accept way|NN
case|NN adult|NN outgrow impatience|NN lack|NN motivation|NN develop tolerance|NN new activity|NN meet|NN new people|NN edit difference|NN affect show range|NN sensory developmental physiological anomaly|NN
children|NN evidence|NN slight delay|NN development|NN fine motor|NN skill|NN
case|NN people|NN odd way|NN walk|NN display compulsive finger|NN hand|NN arm|NN leg|NN movement|NN tics|NN stim|NN general orderly thing|NN appeal|NN people|NN
researcher|NN mention imposition|NN rigid routine|NN self|NN criterion|NN diagnose condition|NN
appear change|NN routine|NN cause inordinate level|NN anxiety|NN people|NN condition|NN people|NN experience|NN vary degree|NN sensory overload|NN extremely sensitive touch smell|NN sound|NN taste|NN sight|NN
prefer soft cloth|NN familiar scent|NN certain food|NN
even pathologically sensitive loud noise|NN people|NN strong smell|NN dislike|NN touch example|NN certain children|NN exhibit strong dislike|NN head|NN touch hair|NN disturb like touch dislike loud noise|NN
sensory overload|NN exacerbate problem|NN face children|NN school|NN level|NN noise|NN classroom|NN become intolerable unable block certain repetitive stimuly|NN constant tick|NN clock|NN
children|NN stop register sound|NN short time|NN hear consciously attend child|NN become distract agitate even case|NN child|NN problem|NN regulate emotion|NN anger|NN aggressive sound|NN persist study|NN parent|NN measure|NN child|NN temperament|NN found children|NN autism|NN rate present extreme score|NN typically-develop children|NN edit history|NN austrian|NN hans|NP asperger|NP observe children|NN practice|NN difficulty|NN integrate socially
intelligence|NN appear normal children|NN lack communication|NN skill|NN fail demonstrate empathy|NN peer|NN physically clumsy
way|NN speak|NN disjoint overly formal all-absorb interest|NN single topic|NN dominate conversation|NN
call condition|NN autistic describe condition|NN primarily mark social isolation|NN state exceptional human give exceptional educational treatment|NN treatment|NN take account|NN special difficulty|NN
further show abnormality|NN human fulfil social role|NN community|NN especially find understand|NN love|NN guidance|NN hans|NP asperger|NP leo|NP kanner|NP identify essentially population|NN group|NN identify asperger|NP perhap socially functional traditionally kannerian autism|NN characterize significant cognitive communicative deficiency|NN delay|NN lack|NN language|NN person|NN show delay|NN language|NN
observation|NN publish german|NN widely known english doctor|NN name lorna|NP wing|NP publish series|NN case|NN study|NN children|NN show similar symptom|NN call syndrome|NN wing|NN write|NN widely publish popularize
publish edition|NN world|NN health|NN organization|NN diagnostic manual|NN international classification|NN disease|NN include make distinct diagnosis|NN later diagnostic statistical manual|NN mental disorder|NN american psychiatric association|NN diagnostic reference|NN book|NN ad uta|NP frith|NP early researcher|NN autism|NN wrote people|NN seem touch|NN autism|NN lorna|NP wing|NN tony|NP attwood|NP share|NN assessment|NN
sally|NP ozonoff|NP university|NN california|NP mind|NN institute|NN argue divide line|NN autism|NN fact|NN people|NN start produce speech|NN later age|NN reason|NN divide group|NN identical way|NN need treate
edit clinical perspective|NN edit|NN research|NN research|NN seek information|NN symptom|NN aid|NN diagnostic process|NN
research|NN identify cause|NN research|NN isolate symptom|NN
study|NN expose base|NN difference|NN area|NN brain|NN structure|NN
end|NN currently unknown research|NN ongo
peter|NP szatmari|NP suggest promote diagnosis|NN spark research|NN syndrome|NN introduce official classification|NN system|NN grown popularity|NN diagnosis|NN even validity|NN clearly establish
interest note introduce indication|NN status|NN true disorder|NN stimulate research|NN validity|NN question|NN
edit|NN research|NN cause|NN direct cause|NN unknown
even consensus|NN exist cause|NN widely accept hereditary factor|NN suspect multiple gene|NN play part|NN cause number|NN severity|NN symptom|NN vary widely individual|NN study|NN mirror|NN neuron|NN inferior parietal cortex|NN reveal difference|NN underlie certain cognitive anomaly|NN exhibit eg understand|NN action|NN learn imitation|NN simulation|NN people|NN behavior|NN factor|NN poverty|NN lack|NN sleep|NN substance|NN abuse|NN mother|NN pregnancy|NN discrimination|NN trauma|NN early childhood|NN abuse|NN contribute possible causative mechanism|NN include serotonin|NN dysfunction|NN dysfunction|NN simon|NP baron-cohen|NP propose model|NN autism|NN base empathising-systemise|NN theory|NN e- theory|NN hold female brain|NN predominantly hard-wire empathy|NN male brain|NN predominantly hard-wire understand|NN build|NN system|NN extreme|NN male brain|NN genetic study|NN point|NN involvement|NN neuroligin|NN
family|NN protein|NN thought mediate interaction|NN neuron|NN
function|NN ligand|NN neurexin family|NN cell|NN surface|NN receptor|NN
mutation|NN x-link|NN gene|NN encod nlgn3|NN report
mutation|NN affect cell-adhesion molecule|NN localize synapse|NN suggest defect|NN synaptogenesis|NN predispose autism|NN edit|NN research|NN study|NN link autism|NN difference|NN enlarge hippocampus|NN current research|NN point|NN structural abnormality|NN brain|NN cause|NN abnormality|NN impact|NN neural circuit|NN control|NN thought|NN behavior|NN
researcher|NN suggest interaction|NN cause gene|NN turn turn turn little wrong place|NN interfere normal migration|NN wire|NN embryonic brain|NN cell|NN early development|NN find|NN include brain|NN region|NN difference|NN decrease gray matter|NN density|NN portion|NN temporal cortex|NN thought play pathophysiology|NN particularly integration|NN visual stimuly|NN affective information|NN differ neural connectivity|NN research|NN infant|NN point|NN early difference|NN reflexe|NN able serve early detector|NN autism|NN professional|NN believe necessarily disorder|NN describe medical term|NN edit treatment|NN treatment|NN coordinate|NN therapy|NN address core|NN symptom|NN poor communication|NN skill|NN obsessive repetitive routine|NN physical clumsiness|NN
autism|NN consider together purpose|NN clinical management|NN typical treatment|NN program|NN generally include social skill|NN train|NN teach skill|NN successfully interact cognitive therapy|NN help better manage emotion|NN explosive anxious cut back obsessive interest|NN repetitive routine|NN medication|NN co-exist condition|NN depression|NN anxiety|NN occupational physical therapy|NN assist sensory integration|NN problem|NN poor motor|NN coordination|NN specialize speech|NN therapy|NN help trouble|NN give take normal conversation|NN parent|NN train|NN support|NN teach parent|NN technique|NN use|NN home|NN counsel|NN support|NN individual|NN increase self-awareness|NN skill|NN help develop manage emotion|NN social experience|NN
technique|NN describe work|NN people|NN syndrome|NN completely cure
modify cope strategy|NN put place|NN
study|NN early behavioral intervention|NN
single case|NN participant|NN single case|NN study|NN usually control non-core autistic problem-behavior|NN self-injury|NN aggression|NN noncompliance|NN spontaneous language|NN
intervention|NN run|NN ucla|NP teacch|NP design treat entire syndrome|NN found somewhat effective behavioral|NN intervention|NN apply behavior|NN analysis|NN aba|NN research year|NN
empirical data|NN demonstrate effectiveness|NN treatment|NN autism|NN spectrum|NN disorder|NN individualize set|NN program|NN
addition|NN aba|NN benefit|NN individualize functional analyse|NN exhibit behavior|NN
becker|NP gersten|NP found aba|NN technique|NN indee educationally beneficial provide motivational program|NN base positive reinforcement|NN token system|NN systematic task|NN analysis|NN develop academic skill|NN
aba|NN promote foundation|NN academic live skill|NN
certain skill|NN acquire possible aba|NN generalize skill|NN add new skill|NN exist repertoire|NN various technique|NN shape|NN extinction|NN backward chain prompt
mayer|NP et|NP al|NP glen|NP lee|NP kern|NP jonathan|NP worcester|NP review study|NN effect|NN apply behavior|NN analysis|NN academic instruction|NN structure|NN exist study|NN article|NN
researcher|NN note study|NN weeks|NP gaylord|NP subject|NN severe disability|NN give difficult task|NN became self|NN injurious aggressive
incorporate use|NN learn|NN technique|NN use aba|NN treatment|NN eliminate wrong answer|NN prompt|NN fade observable reduction|NN challeng behavior|NN
use|NN aba|NN treatment|NN discount intervention|NN autism|NN spectrum|NN disorder|NN foundation|NN repeatable observable study|NN result|NN better educational technique|NN skill|NN acquisition|NN
teach|NN methodology|NN develop primarily gary|NP eric|NP schopler|NP unc-chapel|NP hill|NP
teacch methodology|NN believe appliction|NN behavioral methodology|NN tenet|NN teach|NN system|NN instruct real life|NN set|NN children|NN learn best instruction|NN personalize meaningful
teacch program|NN replication|NN site|NN design work|NN station|NN activity|NN develop chosen child|NN
teacch approach|NN design younger age|NN children|NN require substantially separate program|NN implementation|NN
teacch method|NN intrusive aggressive student|NN exist behavior|NN parent|NN comfort|NN level|NN watch method|NN higher
model|NN offer various manual|NN support help new program|NN establish support exist program|NN implement positive change|NN
research|NN efficacy|NN teacch|NN aba|NN limit anecdotal report|NN empirical data|NN support
aba|NN support effective teach functional social language|NN bridge gap|NN cognitive skill|NN teach|NN self-help|NN functional independence|NN
present challenge|NN
replication|NP original program|NN curriculum|NN challeng program|NN purchase
train|NN staff|NN implement method|NN require significant time|NN personnel|NN excellent background|NN knowledge|NN
effectively implement classroom|NN size|NN student|NN staff|NN ratio|NN small
challenge|NN educational program|NN academic social intervention|NN
side|NN effect|NN medication|NN intervention|NN largely ignor literature|NN treatment|NN program|NN children|NN adult|NN claim|NN treatment|NN ethical harm|NN good edit|NN person|NN appear normal lifespan|NN increase prevalence|NN psychiatric condition|NN depression|NN mood|NN disorder|NN disorder|NN children|NN learn manage difference|NN continue find social situation|NN personal relationship|NN challeng
adult|NN able work successfully mainstream job|NN continue need encouragement|NN moral support|NN maintain independent life|NN individual|NN make great intellectual contribution|NN publish case|NN report|NN suggest association|NN accomplishment|NN computer|NN science|NN mathematics|NN physics|NN
deficit|NN associate debilitate individual|NN experience positive outcome|NN particularly able excel area|NN dependent social interaction|NN mathematics|NN music|NN science|NN edit|NN epidemiology|NN prevalence|NN well establish conservative estimate|NN use dsm-iv criteria|NN indicate children|NN condition|NN make rarer autistic disorder|NN
time|NN boy|NN compare girl|NN universality|NN race|NN validity|NN epidemiologic study|NN date|NN question broad-base population|NN study|NN sweden|NP found school-age|NN children|NN met criteria|NN rise suspect case|NN include estimate|NN convince sweden|NP find|NN apply elsewhere base homogeneous population|NN
sweden|NP study|NN demonstrate common thought currently underdiagnose gillberg|NN estimate|NN person|NN undiagnose survey|NN found adult|NN iq|NN above meet criteria|NN et al document significant difference|NN gillberg criteria|NN icd-10 criteria|NN requirement|NN normal development|NN cognitive skill|NN language|NN curiosity|NN self-help skill|NN icd-10 definition|NN considerably narrow criteria|NN closely matche hans|NP description|NN
autism|NN spectrum|NN disorder|NN prevalence|NN estimate|NN male|NN higher female|NN clinician|NN believe reflect actual incidence|NN rate|NN
tony|NP attwood|NP suggest female|NN learn compensate better impairment|NN due gender|NN difference|NN handle|NN socialization|NN ehler|NN study|NN found male|NN female ratio|NN subject|NN meet criteria|NN lower ratio|NN suspect borderline|NN case|NN include prevalence|NN adult|NN well understood baron-cohen et al document adult|NN score higher autism spectrum|NN questionnaire|NN develop measure extent|NN adult|NN normal intelligence|NN trait|NN associate autism|NN spectrum|NN condition|NN interview met criteria|NN met threshold|NN criteria|NN asd diagnosis|NN japanese study|NN found similar aq|NN test|NN result|NN edit patient|NN present clinical set|NN psychiatric disorder|NN children|NN likely present hyperactivity|NN disorder|NN depression|NN common diagnosis|NN adolescent|NN adult|NN study|NN refer adult|NN patient|NN found present|NN adhd|NP asd well research|NN indicate people|NN far likely associate condition|NN people|NN symptom|NN frequently diagnose clinical depression|NN oppositional defiant disorder|NN antisocial personality|NN disorder|NN syndrome|NN general anxiety|NN disorder|NN bipolar disorder|NN obsessive compulsive disorder|NN personality|NN disorder|NN dyslexia|NN diagnose particularly high comorbidity|NN anxiety|NN require special attention|NN
study|NN report percent|NN individual|NN pervasive developmental disorder|NN met criteria|NN diagnose anxiety|NN disorder|NN social difference|NN experience trouble|NN initiate maintain conversation|NN adherence|NN strict ritual|NN schedule|NN additional stress|NN activity|NN result feel|NN anxiety|NN negatively affect multiple area|NN life|NN school|NN family|NN work|NN
treatment|NN anxiety|NN disorder|NN accompany pdd|NN handle number|NN way|NN medicationcitation|NP need individual group|NN cognitive behavioral|NN therapy|NN relaxation|NN distraction-type|NN activity|NN use along technique|NN order|NN diffuse feel|NN anxiety|NN edit|NN perspective|NN professional|NN contend far disease|NN simply pathologize|NN neurodiversity|NN celebrate understood accommodate instead treate cure edit|NN shift|NN view|NN people|NN contribute shift|NN perception|NN autism|NN spectrum|NN disorder|NN complex syndrome|NN disease|NN cure proponent|NN view|NN reject notion|NN ideal brain|NN configuration|NN deviation|NN norm|NN pathological
demand tolerance|NN call neurodiversity|NN way|NN physically handicap people|NN demand tolerance|NN view|NN basis|NN autistic right|NN autistic pride|NN movement|NN researcher|NN simon|NP baron-cohen|NP argue autism|NN difference|NN necessarily disability|NN
contend term|NN difference|NN neutral small shift|NN term|NN mean difference|NN diagnosis|NN receive family|NN tragedy|NN interest information|NN learn child|NN left-hand
edit culture|NN people|NN refer casual conversation|NN aspy|NN coin liane|NP holliday|NP willey|NP aspergian|NN term|NN nt|NP describe person|NN neurological development|NN state|NN typical use refer people|NN non-autistic
wire magazine|NN article|NN geek syndrome|NN suggest common silicon|NN valley|NN haven|NN computer|NN scientist|NN mathematician|NN
posit result|NN mate|NN geek|NN mathematical technological area|NN
found occupation|NN limit math|NN science|NN field|NN popularization|NN internet|NN allow individual|NN communicate way|NN possible offline due|NN rarity|NN geographic dispersal|NN individual|NN
result|NN increase ability|NN connect subculture|NN aspy|NN form
internet|NN site|NN made easier individual|NN connect edit|NN social impact|NN lead problem|NN social interaction|NN peer|NN
problem|NN severe mild individual
children|NN target|NN bully|NN school|NN due idiosyncratic behavior|NN language|NN interest|NN impair ability|NN perceive respond socially expect way|NN nonverbal cue|NN particularly interpersonal conflict|NN
children|NN extremely literal difficulty|NN interpret|NN respond sarcasm|NN banter|NN
above problem|NN even arise family|NN give unfavorable family|NN environment|NN child|NN subject|NN emotional abuse|NN
child|NN teen|NN puzzle mistreatment|NN unaware incorrectly
pervasive development|NN disorder|NN children|NN want social fail socialize successfully lead later withdrawal|NN behavior|NN especially adolescence|NN stage|NN life|NN especially risk drawn unsuitable inappropriate friendship|NN social group|NN
people|NN get lot|NN better considerably older younger age|NN
children|NN display advance ability|NN age|NN language|NN read|NN mathematics|NN spatial skill|NN musicsometime|NN gift rangebut|NN counterbalance considerable delay|NN developmental area|NN
especially evident children|NN hit middle school|NN educational philosophy|NN switche|NN rote|NN task|NN memorization|NN word|NN fact|NN higher order think|NN difficult children|NN
combination|NN trait|NN lead problem|NN teacher|NN authority|NN figure|NN
child|NN regard teacher|NN problem|NN child|NN poor performer|NN
child|NN extremely low tolerance|NN perceive ordinary mediocre task|NN typical homework|NN assignment|NN easily become frustrate teacher|NN well consider child|NN arrogant spiteful insubordinate
lack|NN support|NN understand|NN combination|NN child anxiety|NN result problematic behavior|NN severe tantrum|NN violent angry outburst|NN withdrawal|NN adult|NN similar problem|NN likely give treatment|NN child|NN
find difficult find|NN employment|NN enter undergraduate|NN graduate|NN school|NN poor interview|NN skill|NN low score|NN standardize personality|NN test|NN
vulnerable poverty|NN homelessness|NN general population|NN difficulty|NN find|NN keep|NN employment|NN lack|NN proper education|NN premature social skill|NN factor|NN become employ misunderstood taken advantage|NN paid subject|NN bully|NN discrimination|NN
communication|NN deficit|NN mean people|NN work|NN difficulty|NN understand person|NN
complex interpersonal dynamic|NN workplace|NN pose assiduous challenge|NN problem|NN authority|NN figure|NN continue difficult tense relation|NN boss|NN supervisor|NN become prevalent
people|NN report|NN feel|NN unwillingly detach world|NN
difficulty|NN find life|NN partner|NN get marry due|NN poor social skill|NN poverty|NN
similar fashion|NN school|NN bully person|NN vulnerable problem|NN neighbourhood|NN anti-social behaviour|NN harassment|NN
due social isolation|NN seen black sheep|NN community|NN risk|NN wrongful suspicion|NN allegation|NN individual|NN need support|NN desire make connection|NN personal level|NN
order|NN see purpose|NN relevance|NN relationship|NN point|NN interest|NN concept|NN represent require facilitation|NN skill professional
connection|NN crucial life|NN individual|NN
connection|NN become incredibly complex adulthood|NN unfortunately service|NN provide population|NN
direct teach|NN identify establish social boundary|NN well recognize person|NN relationship|NN trust necessary social success|NN
complexity|NN inconsistency|NN social world|NN pose extreme challenge|NN individual|NN
hand|NN adult|NN get marry get graduate|NN degree|NN become wealthy hold|NN job|NN intense focus|NN tendency|NN work|NN thing|NN logically grant people|NN high level|NN ability|NN field|NN interest|NN
special interest|NN coincide materially socially useful task|NN person|NN lead profitable life|NN
child|NN obsess naval architecture|NN grow accomplish shipwright|NN research|NN need adult|NN edit|NN adult|NN parent|NN area|NN study|NN research|NN sorely need concern|NN adult|NN marry subsequently become parent|NN
recently assume adult|NN function highly marry known simply untrue
adult|NN marry
marry find difficult stay marry initial research|NN put divorce|NN rate|NN approximately percent|NN routine|NN embarrass social behavior|NN read book|NN guest|NN undermine marriage|NN difficulty|NN maintain emotional closeness|NN
result split|NN fraught intense high conflict|NN domestic violence|NN custody|NN case|NN difficult affair|NN complicate party|NN
parent|NN skill|NN person|NN inadequate task|NN point|NN inflict long-term psychological damage|NN children|NN particularly children|NN raise environment|NN damage|NN even pronounce parent|NN goe undiagnose fail receive intensive help|NN need develop maintain adequate parent|NN skill|NN
even support|NN parent|NN simply enormous task|NN
raise neurotypical child|NN correspond need|NN involve complex emotional interaction|NN parent|NN child|NN well ability|NN avoid parental damage child well-be|NN
typical adult|NN symptom|NN include inability|NN empathize lack|NN comprehension|NN emotion|NN motive|NN difficulty|NN hold conversation|NN actively listen poor ability|NN control|NN feel|NN anxiety|NN importantly anger|NN rage|NN especially stressful situation|NN lead violent aggression|NN sheila|NP jennings|NP note|NN problem|NN time|NN simply incompatible successful parent|NN parent|NN suffer significant mind|NN blindness|NN associate see article|NN family|NN court|NN review|NN oct|NP note child|NN parent|NN himherself parent|NN probably likely understand child|NN deal motivate provide support|NN readily available neurotypical parent|NN
contrast|NN parent|NN run risk|NN know child|NN take wrong inappropriate corrective action|NN diagnosis|NN treatment|NN parent|NN intervention|NN provide parentnt child|NN dynamic|NN nascent understand|NN
kathy|NP j|NP
comment|NN neurotypical adult|NN raise parent|NN undiagnose due|NN relatively recent understand|NN report lifetime|NN severe depression|NN nervous breakdown|NN string|NN broken relationship|NN came believe worth|NN
remember child experience|NN define parent|NN parent|NN love child|NN
child|NN parent|NN perception|NN --|NN parentchild relationship|NN child|NN worth|NN --|NN impact child well-be|NN find|NN crucially important
mean parent|NN love children|NN
parent|NN stereotype categorize evil uncare intentionally abusive
better health|NN channel|NN put affect person|NN neurologically unable understand people|NN emotional state|NN usually shock upset|NN remorseful told action|NN hurtful inappropriate
jennings|NP linehan|NP note problem|NN parent|NN link directly core|NN clinical feature|NN syndrome|NN character|NN flaw|NN ill part|NN parent|NN
seem clear research|NN better cope strategy|NN need part|NN involve welfare|NN child|NN parent|NN parent|NN
edit notable case|NN speculate albert|NP einstein|NP
sometime view syndrome|NN advantage|NN disadvantage|NN notable adult|NN autism|NN achieve success|NN field|NN
prominent as-diagnose|NN individual|NN include nobel|NP economist|NN vernon|NP smith|NP rocker|NN gary|NP numan|NP vines|NP frontman|NN craig|NP nicholls|NP satoshi|NP creator|NN pokmon|NP colorado|NP state|NN university|NN professor|NN author|NN temple|NN diagnose autism|NN young age|NN use autism|NN advantage|NN profession|NN animal|NN specialize livestock|NN handle researcher|NN speculate well-known figure|NN jeremy|NP bentham|NP albert|NP einstein|NP isaac|NP newton|NP glenn|NP gould|NP ludwig|NP wittgenstein|NP show as-relate tendency|NN behavior|NN intense interest|NN subject|NN social problem|NN speculative diagnose|NN especially posthumous remain controversial work biographical information|NN sometime ignore document trait|NN indicate syndrome|NN activist|NN use|NN speculative diagnose|NN argue loss|NN society|NN autism|NN cure edit|NN see group|NN freedom|NN wrong planet|NN national alliance|NN research|NN cure|NN list|NN list|NN fictional character|NN autistic spectrum|NN list|NN further read|NN syndrome|NN general|NN picture|NN think pride|NN day|NN function|NN label|NN autism|NN spectrum|NN edit|NN note|NN
developmental disorder|NN syndrome|NN april|NP
disorder|NN syndrome|NN
wisconsin|NP medical society|NN
retrieve july|NP
wing|NN lorna|NP
syndrome|NN clinical account|NN
clinical capsule|NN
dsm-iv-tr|NN disorder|NN ad
syndrome|NN fact|NN sheet|NN
timini|NP s|NP
diagnosis|NN autism|NN adequate fund|NN need assessment|NN service|NN
14739199 full text|NN
s|NP c|NP
epidemiology|NN syndrome|NN total population|NN study|NN
j|NP child|NN psychiatry|NN
8294522 full text|NN
szatmari|NP p|NP brenner|NP r|NP nagy|NP j|NP syndrome|NN review|NN clinical feature|NN
canadian journal|NN psychiatry|NN pp|NN
ic|NP c|NP
syndrome-some epidemiological consideration|NN research|NN note|NN
j|NP child|NN psychiatry|NN
syndrome|NN information|NN feature|NN definition|NN
fitzgerald|NP m|NP
diagnosis|NN differential diagnosis|NN syndrome|NN
advance|NN psychiatric treatment|NN pp|NN
classification|NN autism|NN syndrome|NN pervasive developmental disorder|NN
j|NP psychiatry|NP
11086556 full text|NN
myles|NP brenda|NP smith|NP melissa|NP schelvan|NP
hidden curriculum|NN practical solution|NN understand|NN unstate rule|NN social situation|NN
mission|NN kansas|NP autism|NP publish|NN co|NN
isbn|NP 1-931282-60-9|NP
levanthal-belfer|NP laurie|NP coe|NP cassandra|NP
syndrome|NN young children|NN developmental approach|NN parent|NN professional|NN
london|NP jessica|NP kingsley|NP publisher|NN p|NN
isbn|NP 1-84310-748-1|NP
romanowski|NP patricia|NP kirby|NP barbara|NP l|NP
oasis|NN guide|NN syndrome|NN
coe|NP pp|NN
baker|NP l|NP la|NP
syndrome|NN clinics|NN school|NN community|NN
baker|NP linda|NP lawrence|NP
syndrome|NN school|NN clinics|NN community|NN new|NP jersey|NP lawrence|NP associate|NN publisher|NN
attwood|NP tony|NP
syndrome|NN guide|NN parent|NN professional|NN
jessica|NP kingsley|NP london|NP
isbn|NP pp|NN
attwood|NP pp|NN
attwood|NP pp|NN
happe|NP f|NP frith|NP weak central coherence|NN account|NN cognitive style|NN autism|NN spectrum|NN disorder|NN
journal|NN autism|NN developmental disorder|NN
attwood|NP pp|NN
bauer|NP s|NP
myles|NP bs|NP huggins|NP et al
written language|NN profile|NN children|NN youth|NN syndrome|NN research|NN practice|NN
education|NN train|NN developmental disability|NN december|NP
attwood|NP pp|NN
baron-cohen|NP s|NP s|NP
obsession children|NN autism|NN syndrome|NN
content|NN analysis|NN term|NN core|NN domain|NN cognition|NN
br|NP j|NP psychiatry|NP
hippler|NP k|NP c|NP 2003-01-08|NP
retrospective analysis|NN clinical case|NN record|NN autistic psychopath|NN diagnose hans|NP team|NN university|NN children|NN hospital|NN vienna|NP
royal society|NN
die psychopathen im|NN archiv|NP fur|NN pp|NN
p|NP e|NP sutton|NP s|NP
sensory motor difference|NN individual|NN syndrome|NN occupational therapy|NN assessment|NN intervention|NN stoddart|NP kevin|NP p|NP
jankovic|NP j|NP ni|NP
tics associate disorder|NN
neurol 20069961-8|NN
mejia|NP ni|NP j|NP
secondary tics|NN tourettism|NN
rev|NP bras|NP 200527111-7|NP
15867978|NN pdf|NP
kirby|NP pp|NN
hepburn|NP sl|NP stone|NN
use carey|NP temperament|NN scale|NN assess style|NN children|NN spectrum|NN disorder|NN
j|NP autism|NP dev|NP april|NP ahead print|NN
kanner|NP l|NP disturbance|NN contact|NN nervous child|NN
note nind|NN syndrome|NN fact|NN sheet|NN list|NN date|NN include dsm|NP dsm-iv|NN publish
frith|NP syndrome|NN
frith|NP ed|NN syndrome|NN
cambridge|NP cambridge|NP university|NN press|NN
ozonoff|NP s|NP rogers|NP sj|NP pennington|NP bf|NP
syndrome|NN evidence|NN empirical distinction|NN autism|NN
journal|NN child|NN psychology|NN psychiatry|NN
stoddart|NP k|NP
children|NN youth|NN adult|NN syndrome|NN integrate multiple perspective|NN
london|NP jessica|NP kingsley|NP publisher|NN
isbn|NP 1-84310-268-4|NP
muhle|NP r|NP sv|NP
genetics|NN autism|NN
oberman|NP lm|NP hubbard|NP em|NP jp|NN el|NP pineda|NP ja|NP eeg|NN evidence|NN mirror|NN neuron|NN dysfunction|NN autism|NN spectrum|NN disorder|NN brain|NN re|NN brain|NN re|NN
dapretto understand|NN emotion|NN mirror|NN neuron|NN dysfunction|NN children|NN autism|NN spectrum|NN disorder|NN nature|NN neuroscience|NP vol|NN pp|NN
larsson|NP hj|NP eaton|NP ww|NP madsen|NP vestergaard|NP m|NP et|NP al|NP
risk|NN factor|NN autism|NN perinatal factor|NN parental psychiatric history|NN socioeconomic status|NN
american journal|NN epidemiology|NN 1516110916-25|NN discussion|NN
15870155full text|NN
murphy|NP dg|NP daly|NP e|NP n|NP et|NP al|NP
serotonin|NN receptor|NN bind|NN social communication|NN adult|NN syndrome|NN spect study|NN
am|NP j|NP psychiatry|NP
gowen|NP e|NP rc|NP
behavioural aspect|NN function|NN adult|NN syndrome|NN
lawson|NP j|NP s|NP s|NP
systemise adult|NN syndrome|NN
j|NP autism|NP dev|NP
baron-cohen|NP simon|NP april|NP
cant help|NN
retrieve july|NP
mutation|NN x-link gene|NN encod nlgn3|NN associate autism|NN
retrieve december|NP
schumann|NP cm|NN j|NP
amygdala|NN enlarge children|NN adolescent|NN autism|NN hippocampus|NN enlarge age|NN
et|NP al|NP
morphometry|NN structural neuroanatomy|NN autism|NN syndrome|NN
dev|NP med child|NN
belmonte|NP mk|NP allen|NP g|NP et al
abnormal development|NN brain|NN connectivity|NN
j|NP october24429228-31|NN full text|NN
clue|NN neural basis|NN
teitelbaum|NP o|NP benton|NP t|NP shah|NP et|NP al|NP
movement|NN notation|NN diagnosis|NN early detection|NN syndrome|NN
natl acad|NN
15282371 full text|NN
make|NN intelligence|NN disease|NN
medical post|NN
colleen|NP clements|NP clinical associate|NN professor|NN psychiatry|NN university|NN rochester|NP rochester|NP ny|NP
determine treatment|NN outcome|NN early intervention|NN program|NN autism|NN spectrum|NN disorder|NN critical analysis|NN measurement|NN issue|NN learn|NN base intervention|NN
re|NN dev|NP ahead print|NN
dawson|NP michelle|NP
people|NN abuse|NN
fombonne|NP e|NP
epidemiology|NN autistic disorder|NN pervasive developmental disorder|NN
j|NP psychiatry|NN 103-8|NN
infantile autism|NN universal phenomenon|NN
open question|NN
int j|NP soc|NP psychiatry|NP
barnard|NP j|NP et|NP al|NP
reality|NN adult|NN
national autistic|NN society|NN london|NP
full text|NN pdf|NP
leekam|NP s|NP et|NP al|NP
comparison|NN icd-10|NN gillberg|NN criteria|NN syndrome|NN
national autistic|NN society|NN publication|NN
baron-cohen|NP s|NP s|NP skinner|NP r|NP martin|NP j|NP e|NP
autism-spectrum quotient|NN evidence|NN syndromehigh-function autism|NN male|NN female|NN scientist|NN mathematician|NN
j|NP autism|NP dev|NP
erratum j|NP dev|NP
11439754 full text|NN
wakabayashy tojo y|NP et|NP al|NP
autism-spectrum|NN japanese version|NN evidence|NN clinical group|NN normal adult|NN japanese
kenkyu apr75178-84|NN
m|NP e|NP n|NP
comorbidity|NP syndrome|NN preliminary report|NN
j|NP intellect re 9786442|NN
h|NP et|NP al|NP
disorder|NN schizophrenia|NN psychotic disorder|NN adult|NN childhood|NN onset|NN autism|NN spectrum|NN disorder|NN
journal|NN neural transmission|NN
stoddart|NP k|NP
children|NN youth|NN adult|NN syndrome|NN integrate multiple perspective|NN
london|NP jessica|NP kingsley|NP publisher|NN
isbn|NP 1-84310-268-4|NP
gillberg|NP c|NP e|NP
syndrome|NN coexistence|NN clinical disorder|NN
psychiatr|NN nov1025321-30|NN
syndrome|NN information|NN feature|NN
muris|NP p|NP et|NP al|NP
anxiety|NN symptom|NN children|NN pervasive developmental disorder|NN
journal|NN anxiety|NN disorder|NN
syndrome|NN anxiety|NN
williams|NP charmaine|NP c|NP
search|NN asperger culture|NN stoddart|NP kevin|NP
williams|NP write life|NN prospect|NN people|NN change shift view|NN set|NN dysfunction|NN view|NN set|NN difference|NN merit|NN
dakin|NP chris|NP j|NP
life|NN personal perspective|NN syndrome|NN stoddart|NP kevin|NP ed|NP pp|NN
baron-cohen|NP simon|NP
syndromehigh-function autism|NN necessarily disability|NN
development|NN summer123489-500|NN
full-text|NP pdf|NP
willey|NP lh|NP
pretend normal live|NN syndrome|NN
jessica|NP kingsley|NP london|NP
isbn|NP 1-85302-749-9|NP
silberman|NP s|NP
geek syndrome|NN
madeleine|NP nash|NP
secret|NN pp|NN
time|NN magazine|NN
dekker|NP martijn|NP
term|NN emerge culture|NN
stoddart|NP kevin|NP p|NP
myles|NP brenda|NP smith|NP southwick|NP jack|NP
syndrome|NN difficult moment|NN
mission|NN kansas|NP autism|NP publish|NN co|NN
isbn|NP pp|NN
retrieve july|NP
stoddart|NP kevin|NP p|NP
stoddart|NP note|NN adult|NN succeed keep employment|NN found vocation|NN rely circumscribe area|NN knowledge|NN
stoddart|NP kevin|NP p|NP
better health|NN channel|NN
syndrome|NN adult|NN
mental health|NN matter|NN
essential difference|NN simon|NP baron|NP cohen|NP
jennings|NP linehan|NP
high conflict|NN syndrome|NN
national autistic|NN society|NN
family|NN adult|NN affect syndrome|NN
syndrome|NN parent|NN
treatment|NN intervention|NN
grandin|NP temple|NP
genius|NN abnormality|NN
pdf|NP paradigm|NP
herera|NP sue|NP february|NP
autism|NN selective advantage|NN
retrieve july|NP
vines|NP singer|NN diagnosis|NN reveal
retrieve july|NP
salute|NN japanese game|NN designer|NN
view|NN autism|NN temple|NP phd|NN
book|NN review|NN animal|NN translation|NN temple|NP phd|NN
lucas|NP philip|NP anne|NP syndrome|NN eccentricity|NN genius|NN jeremy|NP bentham|NP journal|NN bentham|NP study|NN
muir|NP h|NP
einstein|NP newton|NP show sign|NN autism|NN
fulford|NP robert|NP
source|NN genius|NN
great musician|NN suffer asperger|NN national post|NN february|NP
fitzgerald|NP m|NP
ludwig|NP wittgenstein|NP syndrome|NN
christopher|NP gillberg|NP mary|NP coleman|NP biology|NN autistic|NN cambridge|NP university|NN press|NN
lyons|NP v|NP
syndrome|NN gift|NN curse|NN
new|NP york|NP nova|NP science|NN publisher|NN
harmon|NP amy|NP
autistics|NN plead new|NP york|NP december|NP
edit external link|NN link|NN directory|NN organization|NN service|NN category|NN syndrome|NN syndrome|NN resource|NN family|NN village|NN library|NN wrong planet|NN link|NN directory|NN further link syndrome|NN fact|NN sheet|NN fact|NN sheet|NN diagnosis|NN early intervention|NN family|NN issue|NN personal story|NN stephen|NP shore|NN offer insight|NN life|NN syndrome|NN learn sign|NN
act|NN early campaign|NN information|NN parent|NN early childhood|NN development|NN developmental disability|NN institute|NN study|NN neurologically typical well-known parody|NN non-autistics|NN people|NN autism|NN spectrum|NN fresh air|NN terry|NP gross|NP national public radio|NN program|NN aspergers|NP autism|NN publish|NN company|NN independent|NN publisher|NN specialize book|NN autism|NN syndrome|NN key run|NN parent|NN children|NN autism|NN spectrum|NN disorder|NN syndrome|NN little professor|NN h2g2|NP boston|NP globe|NN article|NN woman|NN syndrome|NN developmental disorder|NN spectrum|NN syndrome|NN enterocolitis|NN childhood|NN disorder|NN condition|NN autism|NN fragile syndrome|NN syndrome|NN sensory integration|NN developmental disorder|NN controversy|NN andrew|NP wakefield|NP incidence|NN epidemic|NN
autism right|NN movement|NN biomedical intervention|NN cause|NN generation|NN rescue|NN refrigerator mother|NN see list|NN autism-relate topics|NN
artadhhtml text|NN come free encyclopedia|NN
permission|NN grant copy|NN distribute modify document|NN term|NN gnu free documentation|NN version|NN later version|NN publish free software|NN foundation|NN invariant section|NN front-cover text|NN back-cover text|NN
complete list|NN contributor|NN give article|NN visit|NN correspond entry|NN english wikipedia|NN click|NN history|NN
detail|NN license|NN image|NN visit|NN correspond entry|NN english wikipedia|NN click|NN picture|NN
