keratoconus keratoconus|NN external resource|NN conical cornea|NN characteristic icd-10|NN 3716|NN diseasesdb|NN 001013|NN keratoconus|NN greek kerato- horn|NN cornea|NN cone|NN degenerative non-inflammatory disorder|NN eye|NN structural change|NN cornea|NN cause|NN thin change|NN conical shape|NN normal gradual curve|NN
cause substantial distortion|NN vision|NN multiple image|NN streak sensitivity|NN light|NN report patient|NN
common dystrophy|NN cornea|NN affect person|NN seem occur ethnic group|NN worldwide group|NN prevalence|NN keratoconus|NN greater
typically diagnose patient|NN adolescent year|NN attain severe state|NN
little-understood disease|NN uncertain cause|NN progression|NN diagnosis|NN unpredictable
afflict eye|NN deterioration|NN vision|NN affect patient|NN ability|NN drive car|NN read normal print|NN
lead blindness|NN case|NN corrective lense|NN effective allow patient|NN continue drive legally likewise function|NN normally
further progression|NN disease|NN lead need|NN surgery|NN
uncertainty|NN successfully manage variety|NN clinical surgical technique|NN little impairment|NN patient|NN quality|NN life|NN
content|NN history|NN feature|NN symptom|NN sign|NN diagnosis|NN epidemiology|NN cause|NN treatment|NN contact|NN lense|NN surgical option|NN transplant|NN dalk|NN transplant|NN corneal ring|NN segment|NN insert radial keratotomy|NN collagen|NP c3-r relate disorder|NN see reference|NN note|NN external link|NN edit history|NN practical observation|NN conical cornea|NN ground-break text|NN keratoconus|NP doctoral dissertation|NN german oculist|NN provide early description|NN case|NN keratoconus|NN call diaphanum|NN
british physician|NN john|NP nottingham|NP clearly describe distinguish ectasia|NN cornea|NN nottingham|NP report case|NN conical cornea|NN come attention|NN describe classic feature|NN disease|NN weakness|NN cornea|NN difficulty|NN match|NN corrective|NN lense|NN patient|NN vision|NN
british surgeon|NN william|NP bowman|NP use ophthalmoscope|NN recently invent german physician|NN physicist|NN hermann|NP von|NP helmholtz|NP diagnose describe angle instrument|NN mirror|NN best see conical shape|NN cornea|NN bowman|NP attempt restore vision|NN pull iris|NN fine hook|NN insert cornea|NN stretch pupil|NN vertical stenopeic|NN slit|NN cat|NN
report measure|NN success|NN technique|NN restor vision|NN 18-year old woman|NN previously unable count finger|NN distance|NN inche|NN cm|NN
pioneer swiss ophthalmologist|NN johann|NP horner|NP wrote thesis|NN entitle treatment|NN keratoconus|NN disorder|NN acquire current name|NN
treatment|NN time|NN endorse lead german ophthalmologist|NN albrecht|NP von|NP attempt|NN physically reshape cornea|NN chemical cauterization|NN silver|NN nitrate|NN solution|NN application|NN miosis-cause agent|NN pressure|NN dress|NN
treatment|NN keratoconus|NN became practical application|NN newly-invent contact|NN len|NN french physician|NN manufacture glass|NN shell|NN improve vision|NN compress cornea|NN regular shape|NN start|NN century|NN research|NN keratoconus|NP improve understand|NN disease|NN greatly expand range|NN treatment|NN option|NN
edit|NN feature|NN edit symptom|NN simulation|NN multiple image|NN seen person|NN
candle|NN look appear number|NN light|NN confusedly run nottingham|NP people|NN early keratoconus|NN typically notice minor blure|NN vision|NN come clinician|NN seek corrective lense|NN read|NN drive|NN
early stage|NN symptom|NN keratoconus|NN different refractive defect|NN eye|NN
disease|NN progress vision|NN deteriorate sometime rapidly
visual acuity|NN become impair distance|NN night|NN vision|NN quite poor
individual|NN vision|NN eye|NN markedly worse eye|NN
develop sensitivity|NN bright light|NN eye|NN strain|NN squint order|NN read itch eye|NN
usually little sensation|NN pain|NN
classic symptom|NN keratoconus|NN perception|NN multiple ghost|NN image|NN known monocular polyopia|NN
effect|NN clearly seen high contrast|NN field|NN point|NN light|NN dark background|NN
instead see point|NN person|NN keratoconus|NN see image|NN point|NN spread chaotic pattern|NN
pattern|NN typically change day|NN day|NN time|NN take new form|NN
patient|NN commonly notice|NN streak|NN flare distortion|NN light source|NN
even notice image|NN move relative|NN time|NN heart|NN beat|NN
edit|NN sign|NN diagnosis|NN prior physical examination|NN diagnosis|NN frequently begin ophthalmologist|NN optometrist|NN assessment|NN patient|NN medical history|NN particularly chief complaint|NN visual symptom|NN presence|NN history|NN ocular disease|NN injury|NN affect vision|NN presence|NN family|NN history|NN ocular disease|NN
eye|NN chart|NN standard|NN chart|NN progressively smaller letter|NN use determine patient|NN visual acuity|NN
eye|NN examination|NN procee measurement|NN localise curvature|NN cornea|NN manual keratometer|NN detection|NN irregular astigmatism|NN suggest possibility|NN
severe case|NN excee instrument|NN measure ability|NN
further indication|NN provide retinoscopy|NN light beam|NN focuse patient|NN retina|NN reflection|NN reflex|NN observe examiner|NN tilt light source|NN back|NN forth
ophthalmic condition|NN exhibit scissor|NN reflex|NN action|NN band|NN move blade|NN pair|NN scissor|NN suspect ophthalmologist|NN search characteristic|NN find|NN disease|NN mean|NN slit|NN lamp|NN examination|NN cornea|NN
advance case|NN usually readily apparent examiner|NN provide unambiguous diagnosis|NN specialise test|NN
close examination|NN ring|NN yellow-brown|NN olive-green pigmentation|NN known fleischer ring|NN observe eye|NN fleischer ring|NN cause deposition|NN iron|NN oxide|NN corneal epithelium|NN subtle readily detectable case|NN become evident view cobalt|NN blue filter|NN
similarly subject|NN exhibit vogts|NP fine stress|NN line|NN cornea|NN cause stretch|NN thine striae|NN temporarily disappear slight pressure|NN apply eyebal|NN
highly pronounce cone|NN create v-shape indentation|NN lower eyelid|NN patient|NN gaze|NN direct downward known sign|NN
clinical sign|NN keratoconus|NN normally present long sign|NN become apparent find|NN classic sign|NN disease|NN tend primary diagnostic importance|NN
topogram|NN keratoconic eye|NN handheld keratoscope|NN sometime known disk|NN provide simple non-invasive visualization|NN surface|NN cornea|NN project series|NN concentric ring|NN light|NN cornea|NN
definitive diagnosis|NN obtain use corneal topography|NN automate instrument|NN project|NN illuminate pattern|NN cornea|NN determine topology|NN analysis|NN digital image|NN
topographical map|NN indicate distortion|NN scare|NN cornea|NN keratoconus|NN reveal characteristic steepen|NN curvature|NN usually centreline|NN eye|NN
technique|NN record snapshot|NN degree|NN extent|NN deformation|NN benchmark|NN assess rate|NN progression|NN
particular value|NN detect disorder|NN early stage|NN sign|NN present diagnose degree|NN classify metrics|NN steepness|NN greatest curvature|NN mild d|NP advance d|NP severe d|NP morphology|NN cone|NN nipple|NN small mm|NN oval larger below-center|NN sage globus cornea|NN affect corneal thickness|NN mild
increase use|NN corneal topography|NN led decline|NN use|NN term|NN edit epidemiology|NN national eye|NN institute|NN report|NN common corneal dystrophy|NN united|NP states|NP affect approximately american|NN report|NN place figure|NN high inconsistency|NN due variation|NN diagnostic criteria|NN case|NN severe astigmatism|NN interpret vice long-term study|NN found mean incidence|NN rate|NN new case|NN population|NN year|NN suggest male|NN female|NN ethnicity|NN appear equally susceptible recent study|NN cast doubt|NN suggest higher prevalence|NN female|NN literature|NN vary extent|NN
study|NN carry uk|NP suggest people|NN asian heritage|NN time|NN likely suffer caucasian|NN likely present condition|NN earlier
normally bilateral affect eye|NN distortion|NN usually asymmetric rarely completely identical cornea|NN
unilateral case|NN tend uncommon fact|NN rare mild condition|NN better eye|NN simply limit|NN clinical detection|NN common keratoconus|NN diagnose eye|NN later
condition|NN progress eye|NN vision|NN earlier-diagnose eye|NN persist poorer fellow|NN
edit patient|NN typically present initially mild astigmatism|NN commonly onset|NN puberty|NN diagnose disease|NN late teenage year|NN early
rare case|NN occur children|NN present later adulthood|NN
diagnosis|NN disease|NN early age|NN indicate greater risk|NN severity|NN later life|NN patient|NN vision|NN seem fluctuate period|NN month|NN drive change len|NN prescription|NN frequently condition|NN worsen contact|NN lense|NN become require majority|NN case|NN
course|NN disorder|NN quite variable patient|NN remain stable|NN year|NN indefinitely progress rapidly experience occasional exacerbation|NN long otherwise steady course|NN
commonly progress period|NN year|NN course|NN disease|NN generally cease
hydrop|NN advance case|NN bulge cornea|NN result localize rupture|NN membrane|NN inner layer|NN cornea|NN
humor|NN eye|NN anterior chamber|NN seep cornea|NN membrane|NN
patient|NN experience|NN pain|NN sudden severe cloud|NN vision|NN cornea|NN take translucent milky-white|NN appearance|NN known corneal hydrop|NN disconcert patient|NN effect|NN normally temporary period|NN week|NN cornea|NN usually return transparency|NN
recovery|NN aid non-surgically bandage|NN osmotic saline solution|NN
hydrop|NN usually cause increase scare|NN cornea|NN occasionally benefit patient|NN create flatter cone|NN aid fit|NN contact|NN lense|NN occasionally extreme case|NN cornea|NN thin point|NN partial rupture|NN occur result small bead-like|NN swell|NN cornea|NN fill fluid|NN
occur corneal transplant|NN become urgently necessary avoid complete rupture|NN result loss|NN eye|NN edit|NN cause|NN considerable research|NN etiology|NN keratoconus|NN remain somewhat mystery|NN
united|NP states|NP national keratoconus|NN foundation|NN likely arise number|NN different factor|NN genetic environmental cellular form trigger|NN onset|NN disease|NN
initiate disease|NN normally develop progressive dissolution|NN layer|NN membrane|NN ly corneal epithelium|NN stroma|NN
come contact|NN cellular structural change|NN cornea|NN adversely affect integrity|NN lead|NN bulge scare characteristic disorder|NN
individual keratoconic|NN cornea|NN found region|NN degenerative thine|NN coexist region|NN undergo wound|NN heal|NN
visual distortion|NN experience patient|NN come source|NN irregular deformation|NN surface|NN cornea|NN scare|NN occur expose highpoint|NN
factor|NN act form|NN region|NN cornea|NN map|NN image|NN different location|NN retina|NN give rise|NN symptom|NN monocular polyopia|NN
effect|NN worsen low light|NN condition|NN dark-adapt pupil|NN expose irregular surface|NN cornea|NN
appear aspect|NN corneal degradation|NN recent large multi-center|NN study|NN suggest abrasion|NN contact|NN lense|NN increase likelihood|NN find|NN factor|NN number|NN study|NN indicate cornea show|NN sign|NN increase activity|NN protease|NN class|NN enzyme|NN break collagen|NN corneal stroma|NN simultaneous reduce expression|NN protease|NN inhibitor|NN study|NN suggest reduce activity|NN enzyme|NN dehydrogenase|NN responsible build-up|NN free radical|NN oxidise specy|NN cornea|NN seem likely pathogenetical process|NN damage|NN cause activity|NN cornea|NN result|NN reduction|NN thickness|NN strength|NN
genetic predisposition|NN keratoconus|NP observe disease|NN run|NN certain family|NN incidence|NN report concordance|NN identical twin|NN
frequency|NN occurrence|NN close family|NN member|NN clearly define known considerably higher general population|NN study|NN obtain estimate|NN rang responsible gene|NN identify study|NN involve isolate largely community|NN map putative gene|NN location|NN chromosome|NN 20q genetic study|NN agree autosomal dominant model|NN inheritance|NN
diagnose people|NN syndrome|NN reason|NN link|NN determine associate atopic disease|NN include asthma|NN allergy|NN eczema|NN uncommon disease|NN affect person|NN
number|NN study|NN suggest vigorous eye|NN rub|NN contribute progression|NN keratoconus|NN patient|NN discourage practice|NN edit|NN treatment|NN edit|NN contact|NN lense|NN early stage|NN keratoconus spectacle|NN suffice correct mild astigmatism|NN
condition|NN progress spectacle|NN longer provide patient|NN satisfactory degree|NN visual acuity|NN clinical practitioner|NN move manage condition|NN contact|NN lense|NN
rigid ga|NN permeable len|NN keratoconus|NN keratoconic patient|NN contact|NN lense|NN improve vision|NN mean|NN tear|NN fluid|NN fill gap|NN irregular corneal surface|NN smooth regular inner surface|NN len|NN thereby create effect|NN smoother cornea|NN
specialize type|NN contact|NN lense|NN develop keratoconus|NN affect people|NN seek doctor|NN specialize condition|NN cornea|NN contact-len|NN fitter|NN experience|NN manage patient|NN
irregular cone|NN present challenge|NN fitter|NN endeavour produce len|NN optimal contact|NN stability|NN steepness|NN
trial-and-error fit|NN prove necessary traditionally contact|NN lense|NN keratoconus|NP hard rigid gas-permeable|NN variety|NN manufacturer|NN produce specialize soft hydrophilic lense|NN
soft len|NN tendency|NN conform conical shape|NN cornea|NN diminish effect|NN
counter hybrid lense|NN develop hard centre|NN encompass soft skirt|NN
soft hybrid lense|NN prove effective patient|NN patient|NN find good vision|NN correction|NN comfort|NN piggyback|NN len|NN combination|NN ga|NN permeable rigid lense|NN worn soft lense|NN provide degree|NN vision|NN correction|NN form|NN piggyback|NN len|NN make use|NN soft len|NN countersunk|NN central area|NN accept rigid len|NN
fit piggyback|NN len|NN combination|NN require experience|NN part|NN len|NN fitter|NN tolerance|NN part|NN keratoconic patient|NN
lense|NN sometime prescribe case|NN advance irregular lense|NN cover greater proportion|NN surface|NN eye|NN offer improve stability|NN larger size|NN lense|NN make unappeal uncomfortable easier handle|NN find favour|NN patient|NN reduce dexterity|NN elderly
edit surgical option|NN edit transplant|NN transplant|NN approximately week|NN surgery|NN
multiple light|NN reflection|NN indicate fold|NN cornea|NN later resolve
case|NN progress|NN point|NN vision|NN correction|NN longer possible thine|NN cornea|NN become excessive scare|NN result|NN contact|NN len|NN wear|NN cause problem|NN corneal transplantation|NN penetrate keratoplasty|NN become require
common ground|NN conduct penetrate keratoplasty|NN generally account|NN quarter|NN procedure|NN corneal transplant|NN surgeon|NN lenticule|NN corneal tissue|NN graft donor|NN cornea|NN exist eye|NN tissue|NN usually use combination|NN run|NN individual suture|NN
cornea|NN direct blood|NN supply|NN donor|NN tissue|NN require blood|NN type|NN match
eye|NN bank|NN check donor|NN disease|NN cellular irregularity|NN
acute recovery|NN period|NN take week|NN full post-operative vision|NN stabilization|NN take year|NN transplant|NN stable long term|NN national keratoconus|NN foundation|NN report penetrate keratoplasty|NN successful outcome|NN transplant|NN procedure|NN perform keratoconus|NN otherwise healthy eye|NN success|NN rate|NN greater suture|NN use usually dissolve period|NN year|NN individual suture|NN remove heal|NN process|NN cause irritation|NN patient|NN
usa|NP corneal transplant|NN known corneal graft|NN keratoconus|NN usually perform sedation|NN outpatient|NN surgery|NN
country|NN australia|NP uk|NP operation|NN commonly perform patient|NN undergo general anaesthetic|NN
case|NN require careful follow-up|NN eye|NN surgeon|NN ophthalmologist|NN number|NN year|NN
frequently vision|NN greatly improve surgery|NN even actual visual acuity|NN improve cornea|NN normal shape|NN heal|NN complet patient|NN easily fit corrective lense|NN
complication|NN corneal transplant|NN mostly relate vascularization|NN corneal tissue|NN rejection|NN donor|NN cornea|NN
vision|NN loss|NN rare vision|NN possible
rejection|NN severe repeat|NN transplant|NN attempt frequently successful keratoconus|NN normally reoccur transplant cornea|NN incidence|NN observe usually attribute incomplete excision|NN original cornea|NN inadequate screen|NN donor|NN tissue|NN long-term outlook|NN corneal transplant|NN perform keratoconus|NN usually favorable initial heal|NN period|NN complet year|NN elapse problem|NN
edit transplant|NN way|NN reduce risk|NN rejection|NN use newer technique|NN call deep anterior|NN keratoplasty|NN refer
dalk graft|NN outermost epithelium|NN main bulk|NN cornea|NN stroma|NN replace patient|NN endothelium|NN layer|NN retain give additional structural integrity|NN post-graft cornea|NN
graft|NN rejection|NN usually begin endothelium|NN chance|NN rejection|NN episode|NN greatly reduce
furthermore possible transplant|NN tissue|NN donor|NN freeze-dry
freeze-dry process|NN ensure tissue|NN dead chance|NN rejection|NN
surgeon|NN prefer remove donor|NN epithelium|NN leave donor|NN cell|NN place|NN
remove cause slight improvement|NN overal vision|NN correspond increase|NN visual recovery|NN time|NN
edit rarely non-penetrate keratoplasty|NN known epikeratophakia|NN perform case|NN
corneal epithelium|NN remove lenticule|NN donor|NN cornea|NN graft top|NN
procedure|NN require greater level|NN skill|NN part|NN surgeon|NN frequently perform penetrate keratoplasty|NN outcome|NN generally
seen option|NN number|NN case|NN particularly young patient|NN edit ring|NN segment|NN insert recent surgical alternative|NN corneal transplant|NN insertion|NN corneal ring|NN segment|NN
small incision|NN made periphery|NN cornea|NN thin arcs|NN methacrylate|NN slid layer|NN corneal stroma|NN side|NN pupil|NN incision|NN close
segment|NN push curvature|NN cornea|NN flatten peak|NN cone|NN return natural shape|NN
procedure|NN carry outpatient|NN basis|NN local anaesthesia|NN offer benefit|NN reversible even potentially exchangeable involve removal|NN eye|NN tissue|NN
principal type|NN intrastromal ring|NN available known trade|NN name|NN intacs|NN ferrara|NP ring|NN
flatter centrally place prismatic|NP ferrara|NP ring|NN
approve food|NN drug|NN administration|NN fda|NN united|NP states|NP myopia|NN extend treatment|NN keratoconus|NN july|NP ferrara|NP ring|NN await fda|NN approval|NN
development|NN concept|NN involve injection|NN transparent synthetic gel|NN channel|NN bore stroma|NN
gel|NN stiffen take similar property|NN pre-form|NN ring clinical study|NN effectiveness|NN intrastromal ring|NN keratoconus|NN early stage|NN result|NN far generally encourage enter wide acceptance|NN refractive surgeon|NN
common penetrate keratoplasty|NN requirement|NN vision|NN correction|NN form|NN hydrophilic soft contact|NN lense|NN spectacle|NN remain subsequent operation|NN
potential complication|NN intrastromal ring|NN include accidental penetration|NN anterior chamber|NN form channel|NN post-operative infection|NN cornea|NN migration|NN extrusion|NN segment|NN ring|NN offer good chance|NN vision|NN improvement|NN even otherwise hard manage eye|NN guarantee case|NN worsen
edit|NN radial|NN radial keratotomy|NN refractive surgery|NN procedure|NN surgeon|NN make spoke-like pattern|NN incision|NN cornea|NN modify shape|NN
early surgical option|NN myopia|NN largely supersed lasik|NN similar procedure|NN
lasik|NP absolutely contraindicate keratoconus|NN corneal thine|NN condition|NN use people|NN keratoconus|NN removal|NN corneal stromal tissue|NN further damage thin weak cornea|NN similar reason|NN radial keratotomy|NN generally use keratoconic patient|NN italian clinic|NN report success|NN modify asymmetric radial keratotomy|NN procedure|NN incision|NN confine sector|NN eye|NN
corneal thickness|NN measure use pachymeter|NN surgeon|NN make cut|NN depth|NN 70-80|NN measure thickness|NN
patient|NN initially experience fluctuation|NN vision|NN radial keratotomy|NN form|NN refractive surgery|NN edit|NN collagen|NP riboflavin|NN new treatment|NN show success|NN approve country|NN collagen|NN riboflavin|NN one-time application|NN eye|NN drop|NN eye|NN riboflavin|NN activate approximately minute|NN illumination|NN light|NN augment collagen|NN stroma|NN recover cornea mechanical strength|NN
develop technische|NN dresden|NP show slow arrest progression|NN keratoconus|NN case|NN even reverse particularly apply combination|NN ring|NN segment|NN
clinical trial|NN continue date|NN relatively procedure|NN perform technique|NN show promise|NN treate early case|NN disease|NN corrective lense|NN require treatment|NN hope limit further deterioration|NN patient|NN vision|NN reduce case|NN
edit relate disorder|NN non-inflammatory eye|NN disorder|NN generally rarer cause thine|NN cornea|NN keratoglobus|NN rare condition|NN genetically relate
cause corneal thine|NN primarily margin|NN result spherical slightly enlarge eye|NN
marginal degeneration|NN marginal degeneration|NN cause|NN thine|NN narrow mm|NN band|NN cornea|NN usually inferior corneal margin|NN
cause irregular astigmatism|NN correct spectacle|NN
keratoconus|NN posterior keratoconus|NN distinct disorder|NN similar name|NN
rare abnormality|NN usually congenital cause non-progressive thine|NN inner surface|NN cornea|NN
keratoconus generally affect single eye|NN
edit see list|NN eye|NN disease|NN disorder|NN edit|NN reference|NN r|NP
disease|NN cornea|NN
isbn|NP 0-8151-3654-4|NP
brown|NP d|NP
research|NN overview|NN
national keratoconus|NN foundation|NN
burger|NP d|NP j|NP k|NP
diagnosis|NN management|NN
pacific|NP university|NN college|NN
caroline|NP p|NP andre|NP m|NP b|NP choo|NP j|NP
diagnosis|NN management|NN new thought|NN new understand|NN
pacific|NP university|NN college|NN
relate disorder|NN pdf|NP
north|NP shore|NP contact|NN
feder|NP r|NP p|NP
chap|NN disorder|NN edit j|NP
isbn|NP 0-323-02315-0|NP
heverly|NP v|NP lowther|NP g|NP
school|NN optometry|NP indiana|NP university|NN
rabonitz|NP y|NP
disorder|NN cornea|NN edit foster|NP c|NP et|NP al|NP
cornea ed|NP
isbn|NP 0-7817-4206-4|NP
yanoff|NP m|NP j|NP
isbn|NP 0-323-01634-0|NP
zadnik|NP k|NP barr|NP j|NP
diagnosis|NN contact|NN prescribe care|NN keratoconus patient|NN
butterworth|NP heinemann|NP
isbn|NP 0-7506-9676-1|NP
edit|NN note|NN
nottingham|NP j|NP
practical observation|NN conical cornea|NN short sight|NN defect|NN vision|NN connect
london|NP j|NP
canadian archive|NN
bowman|NP w|NP conical cornea|NN treatment|NN operation|NN
hosp rep|NN j|NP r|NP ophthalmic|NP hosp|NP
horner|NP jf|NP behandlung|NP des|NP
monatsblätter für|NN
kalt|NP e|NP report panas|NP p|NP translate pearson|NP r|NP
keratoconus|NN contact|NN len|NN
bull|NP med pmid|NN
nordan|NP lt|NP
diagnosis|NN treatment|NN
int ophthalmol|NN
zadnik|NP k|NP
ocular examination|NN measurement|NN find|NN
philadelphia|NP wb|NP
isbn|NP 0-7216-5209-3|NP
tb|NN k|NP barr|NP jt|NP
clin 19954365-73|NN
jh|NP rs|NP mw|NN
relate corneal thine|NN disorder|NN
ophthalmol jan-feb284293-322|NN
maguire|NP lj|NP bourne|NP wm|NP
topography|NN early keratoconus|NN
am|NP j|NP aug|NP
caroline|NP p|NP andre|NP m|NP b|NP choo|NP j|NP
diagnosis|NN management|NN new thought|NN new understand|NN
pacific|NP university|NN college|NN
gupta|NP d|NP
keratoconus clinical update|NN pdf|NP
national eye|NN institute|NN fact|NN cornea|NN disease|NN
kennedy|NP bourne|NP wm|NP dyer|NP ja|NP
48-year clinical epidemiologic study|NN
am|NP j|NP mar|NP
ba|NN kk|NP
emedicine keratoconus|NN
fink|NP ba|NP wagner|NP h|NP k|NP c|NP t|NP mcmahon|NP gordon|NP mo|NP k|NP
difference|NN keratoconus|NN function|NN gender|NN
am|NP j|NP
pearson|NP b|NP n|NP jh|NP
ethnic origin|NN influence|NN incidence|NN severity|NN
davis|NP lj|NP
current understand|NN diagnosis|NN management|NN
eye|NN care|NN 1997doi101016s0953-44319600201-9|NN
s|NP pr|NP cohen|NP rapuano|NP cj|NP
acute hydrop|NN corneal associate factor|NN outcome|NN
trans|NP am|NP soc|NP 199997187-98|NP 10703124|NP
brown|NP d|NP
national keratoconus|NN foundation|NN research|NN overview|NN
barr|NP jt|NP wilson|NP bs|NP gordon|NP mo|NP mj|NP riley|NP c|NP ps|NN k|NP study|NN group|NN
estimation|NN incidence|NN factor|NN predictive corneal scare|NN collaborative longitudinal evaluation|NN clek study|NN
e|NP g|NP t|NP
increase resistance|NN cornea|NN enzymatic digestion|NN
eye|NN re|NN
td|NN et|NP al|NP
analysis|NN corneal aldehyde|NN dehydrogenase|NN pattern|NN cornea|NN
edwards|NP m|NP mcghee|NP dean|NP s|NP
experiment|NN dec296345-51|NN
zadnik|NP k|NP barr|NP jt|NP tb|NN everett|NP df|NN jameson|NP m|NP mcmahon|NP shin|NN ja|NP sterl|NN wagner|NP h|NP gordon|NP mo|NP
baseline|NN find|NN collaborative longitudinal evaluation|NN clek study|NN
invest vis|NN dec39132537-46|NN
eye|NN disorder|NN diagnosis|NN management|NN
boca|NP raton|NP taylor|NP francis|NP
isbn|NP 1-57444-839-0|NP
ophthalmol jan-feb424297-319|NN
mcmonnies|NP cw|NP gc|NP
allergy|NN itch|NN
exp|NN nov866376-84|NN
bawazeer|NP am|NP hodge|NP wg|NP lorimer|NP b|NP
multivariate analysis|NN
br|NP j|NP
jafri|NP b|NP h|NP rd|NP
keratoconus|NN attribute eye|NN rub|NN
speedwell|NP l|NP kk|NP
unilateral keratoconus|NN child|NN chronic persistent eye|NN rub
am|NP j|NP
lindsay|NP rg|NP bruce|NP gutteridge|NP
keratoconus associate continual eye|NN rub due agenesis|NN
rubinstein|NP mp|NP sud|NP s|NP
use|NN hybrid lense|NN management|NN irregular cornea|NN
len|NN eye|NN
yeung|NP k|NP f|NP ba|NP
clinical experience|NN piggyback|NN contact|NN len|NN system|NN keratoconic eye|NN
j|NP am|NP optom|NP
kw|NN buckley|NP rj|NP
study|NN patient|NN refer rigid ga|NN permeable scleral|NN contact|NN len|NN assessment|NN
schirmbeck|NP t|NP paula|NP js|NP martin|NP lf|NP filho|NP h|NP e|NP
low cost|NN treatment|NN rigid gas-permeable contact|NN len|NN
ma|NP bf|NP z|NP souri|NP h|NP s|NP
outcome|NN penetrate keratoplasty|NN
mamalis|NP n|NP anderson|NP cw|NP kr|NP mk|NP olson|NP
chang trend|NN indication|NN penetrate keratoplasty|NN
arch|NN oct110101409-11|NN
al-mezaine|NP h|NP md|NN
repeat penetrate keratoplasty|NN indication|NN graft|NN survival|NN visual outcome|NN
br|NP j|NP
rubinfeld|NP rs|NP ei|NP jj|NP eagle|NN rc|NP jr|NP
keratoconus penetrate keratoplasty|NN
surg jun216420-2|NN
md|NN smith|NP sd|NP wj|NP mahmood|NP ma|NP
keratoplasty|NN epikeratoplasty|NN surgical treatment|NN
j|NP refract|NP
fda|NP new|NP humanitarian device|NN approval|NN prescription|NN keratoconus|NN
simon|NP g|NP jm|NP lee|NP w|NP gn|NP
gel|NN injection|NN adjustable keratoplasty|NN
arch|NN ophthalmol 19912295418-24|NN
ruckhofer|NP j|NP
clinical histological study|NN intrastromal corneal ring|NN segment|NN klin|NN aug2198555-6|NN
miranda|NP d|NP sartori|NP m|NP c|NP n|NP ferrara|NP p|NP campos|NP m|NP
ferrara|NP corneal ring|NN segment|NN severe keratoconus|NN
j|NP refract|NP
jabbur|NP ns|NP stark|NP green|NP wr|NP
ectasia|NN laser-assist|NN keratomileusis|NN
colin|NP j|NP s|NP
current surgical option|NN keratoconus|NP j|NP refract|NP
jp|NN farmer|NN
return|NN primitive practice|NN
radial keratotomy|NN revisit
len|NN eye|NN
m|NP m|NP radial keratotomy|NN correction|NN
j|NP refract|NP
spoerl|NP e|NP g|NP dd|NP t|NP
behavior|NN porcine cornea|NN
guttman|NP c|NP
early respond corneal italian study|NN show significant improvement|NN bscva ophthalmology|NN nov|NP
edit external link|NN association|NN australia|NP national keratoconus|NN foundation|NN usa|NP keratoconus|NP self|NN help|NN support|NN group|NN uk|NP keratoconus|NP family|NN support|NN group|NN kc|NP global global keratoconus|NN support|NN group|NN international web|NN article|NN c3-r treatment|NN keratoconus|NN help keratoconus patient|NN cope|NP schendowich|NN watch|NN sign|NN signal|NN keratoconus individual|NN experience|NN keratoconus|NP john|NP transplant|NN diary|NN keratoconus|NN resource|NN actor|NN mandy|NP patinkin|NP describe corneal transplant|NN angeles|NP vision|NN clinic|NN keratoconus treatment|NN option|NN
homepage|NP collaborative longitudinal evaluation|NN clek study|NN manufacturer|NN site|NN rose|NP k|NP manufacturer|NN site|NN vision|NN simulation|NN see people|NN keratoconus|NN see
artamvhtml text|NN come free encyclopedia|NN
permission|NN grant copy|NN distribute modify document|NN term|NN gnu free documentation|NN version|NN later version|NN publish free software|NN foundation|NN invariant section|NN front-cover text|NN back-cover text|NN
complete list|NN contributor|NN give article|NN visit|NN correspond entry|NN english wikipedia|NN click|NN history|NN
detail|NN license|NN image|NN visit|NN correspond entry|NN english wikipedia|NN click|NN picture|NN
