gastritis wikipedia|NN free encyclopedia|NN jump|NN navigation|NN jump|NN search|NN helicobacter|NN magjpg|NN show gastritis|NN
gastroenterology symptom|NN upper abdominal pain|NN nausea|NN vomit|NN bloat|NN loss|NN appetite|NN heartburn|NN complication|NN bleed stomach|NN ulcer|NN stomach|NN pernicious anemia duration|NN short|NP long term|NN cause|NN helicobacter|NN pylory|NN nsaids|NP alcohol|NN smoke|NN cocaine|NN severe illness|NN autoimmune|NN problem|NN diagnostic method|NN endoscopy|NN upper gastrointestinal series|NN blood|NN test|NN stool|NN test|NN differential diagnosis|NN infarction|NN inflammation|NN pancrea|NN problem|NN peptic ulcer|NN disease|NN treatment|NN blocker|NN proton|NN pump|NN inhibitor|NN antibiotics|NN frequency|NN people|NN death|NN
inflammation|NN line|NN stomach|NN occur short episode|NN long duration|NN symptom|NN symptom|NN present common upper abdominal pain|NN possible symptom|NN include nausea|NN vomit|NN bloat|NN loss|NN appetite|NN heartburn|NN complication|NN include bleed stomach|NN ulcer|NN stomach|NN due autoimmune|NN problem|NN low red blood|NN cell|NN due vitamin|NN occur condition|NN known pernicious anemia|NN
common cause|NN include infection|NN helicobacter|NN pylory|NN use|NN anti-inflammatory drug|NN nsaids|NP common cause|NN include alcohol|NN smoke|NN cocaine|NN severe illness|NN autoimmune|NN problem|NN radiation|NN therapy|NN disease|NN endoscopy|NN type|NN x-ray|NN known upper gastrointestinal series|NN blood|NN test|NN stool|NN test|NN help diagnosis|NN symptom|NN gastritis|NN presentation|NN myocardial infarction|NN condition|NN similar symptom|NN include inflammation|NN pancrea|NN problem|NN peptic ulcer|NN disease|NN
prevention|NN avoid thing|NN cause disease|NN treatment|NN include medication|NN antacid|NN blocker|NN proton|NN pump|NN inhibitor|NN acute attack|NN drink viscous lidocaine|NN help gastritis|NN due nsaids|NP stop h|NP pylory|NN present treate combination|NN antibiotics|NN amoxicillin|NN clarithromycin|NN pernicious anemia vitamin|NN supplement|NN recommend mouth|NN injection|NN people|NN usually advise avoid food|NN bother
believe affect people|NN worldwide 2013|NN approximately new case|NN condition|NN people|NN get older disease|NN become common along similar condition|NN part|NN intestine|NN known duodenitis|NN result death|NN h|NP pylory|NN discover barry|NP marshall|NP robin|NP warren|NP content|NN
sign|NN symptom|NN cause|NN helicobacter|NN pylory|NN critical illness|NN diet|NN acute chronic diagnosis|NN treatment|NN history|NN see reference|NN external link|NN
sign|NN symptom|NN peptic ulcer|NN accompany gastritis|NN
endoscopic image|NN
people|NN gastritis|NN experience|NN symptom|NN
upper central abdominal pain|NN common symptom|NN pain|NN dull vague burn ach gnaw|NN sore|NN sharp pain|NN usually locate upper central portion|NN abdomen|NN occur anywhere upper left portion|NN abdomen|NN back|NN
sign|NN symptom|NN include follow
nausea|NN vomit|NN clear green|NN yellow blood-streak|NN completely bloody severity|NN stomach|NN inflammation|NN usually relieve stomach|NN pain|NN present early satiety|NN loss|NN appetite|NN weight|NN loss|NN
common cause|NN include helicobacter|NN pylory|NN nsaids|NP
common cause|NN include alcohol|NN cocaine|NN severe illness|NN crohn|NP disease|NN helicobacter|NN pylory|NN
helicobacter|NN pylory|NN stomach|NN world|NN population|NN infection|NN continue play key role|NN pathogenesis|NN number|NN gastroduodenal disease|NN
colonization|NP gastric mucosa|NN helicobacter|NN pylory|NN result|NN development|NN chronic gastritis|NN infect individual|NN subset|NN patient|NN chronic gastritis|NN progress complication|NN eg ulcer|NN disease|NN stomach|NN cancer|NN distinct extragastric|NN disorder|NN percent|NN individual|NN infect bacterium|NN asymptomatic postulate play important role|NN natural stomach|NN ecology|NN critical illness|NN
develop major surgery|NN traumatic injury|NN cushing|NP ulcer|NN burn curl|NN ulcer|NN severe infection|NN
occur weight|NN loss|NN surgery|NN result band|NN reconstruction|NN digestive tract|NN
evidence|NN support role|NN specific food|NN spicy food|NN coffee|NN development|NN peptic ulcer|NN people|NN usually advise avoid food|NN bother acute
acute erosive gastritis|NN typically involve discrete focy|NN surface|NN necrosis|NN due damage|NN mucosal defenses|NP nsaids|NP inhibit enzyme|NN responsible biosynthesis|NN eicosanoid|NN stomach|NN increase possibility|NN peptic ulcer|NN form nsaids|NP aspirin|NN reduce substance|NN protect stomach|NN call prostaglandin|NN
drug|NN use short period|NN typically dangerous
regular use|NN lead gastritis|NN additionally severe physiologic|NN stress|NN stress|NN ulcer|NN sepsis|NN hypoxia|NN trauma|NN surgery|NN common etiology|NN acute erosive gastritis|NN
form|NN gastritis|NN occur hospitalize patient|NN
note alcohol|NN consumption|NN cause chronic gastritis|NN
erode mucosal line|NN stomach|NN low dose|NN alcohol|NN stimulate hydrochloric acid|NN secretion|NN
high dose|NN alcohol|NN stimulate secretion|NN acid|NN chronic
chronic gastritis|NN refer wide range|NN problem|NN gastric tissue|NN immune system|NN make protein|NN antibody|NN fight|NN infection|NN body|NN maintain homeostatic condition|NN
disorder|NN body|NN target|NN stomach|NN foreign protein|NN pathogen|NN make antibody|NN severely damage|NN even destroy stomach|NN line|NN case|NN bile|NN normally use aid|NN digestion|NN small intestine|NN enter pyloric valve|NN stomach|NN remove surgery|NN work properly lead gastritis|NN
cause medical condition|NN crohn disease|NN certain connective tissue|NN disorder|NN liver|NN kidney|NN failure|NN
chronic gastritis|NN lesion|NN classify sydney|NP system|NN
gland|NN metaplasia|NN reversible replacement|NN differentiate cell|NN occur set|NN severe damage|NN gastric gland|NN waste atrophic gastritis|NN progressively replace mucous|NN gland|NN
gastric ulcer|NN develop unclear cause|NN consequence|NN
intestinal metaplasia|NN typically begin response|NN chronic mucosal injury|NN antrum|NN extend body|NN
gastric mucosa|NN cell|NN change resemble intestinal mucosa|NN even assume absorptive characteristics|NN
intestinal metaplasia|NN classify histologically complete incomplete
complete metaplasia|NN gastric mucosa|NN completely transform mucosa|NN histologically functionally ability|NN absorb nutrient|NN secrete peptide|NN
incomplete metaplasia|NN epithelium|NN assume histologic appearance|NN closer large intestine|NN frequently exhibit dysplasia|NN diagnosis|NN
diagnosis|NN made base patient|NN description|NN symptom|NN method|NN use verify gastritis|NN include
blood|NN test|NN blood|NN cell|NN count|NN presence|NN h|NP pylory|NN liver|NN kidney|NN pancrea|NN function|NN stool|NN sample|NN look blood|NN stool|NN x-ray|NN endoscopy|NN check stomach|NN line|NN inflammation|NN mucous|NN erosion|NN stomach|NN biopsy|NN test|NN gastritis|NN condition|NN
common treatment|NN mild medium|NN gastritis|NN antacid|NN provide relief|NN medication|NN blocker|NN proton-pump inhibitor|NN help|NN reduce amount|NN acid|NN prescribe
agent|NN design help protect tissue|NN line|NN stomach|NN small intestine|NN include medication|NN sucralfate|NN misoprostol|NN
nsaids|NP taken regularly medication|NN protect stomach|NN taken
cytoprotective agent|NN bismuth|NN need
regimen|NN use treat h|NP pylory|NN infection|NN
use|NN combination|NN antibiotics|NN proton|NN pump|NN inhibitor|NN
sometime bismuth|NN ad regimen|NN
ad gave description|NN stomach|NN cancer|NN
german physician|NN georg|NP ernst|NP stahl|NP coin term|NN gastritis|NN
italian anatomical pathologist|NN giovanni|NP battista|NP further describe characteristics|NN gastric inflammation|NN
describe characteristics|NN erosive ulcerative gastritis|NN erosive gastritis|NN
french physician|NN gather information|NN autopsy|NN dead french soldier|NN
describe chronic gastritis|NN gastritide|NN erroneously believe gastritis|NN cause|NN ascite|NN typhoid fever|NN meningitis|NN
charles|NP jones|NP wilson|NP fox|NP describe microscopic change|NN stomach|NN inner line|NN gastritis|NN exist diffuse segmental form|NN
baron|NP carl|NP von|NP describe gastritis|NN
british physician|NN william|NP brinton|NP describe acute subacute|NN chronic gastritis|NN
samuel|NP fenwick|NP note pernicious anemia|NN cause glandular atrophy|NN gastritis|NN
german surgeon|NN georg|NP ernst|NP konjetzny|NP notice gastric ulcer|NN gastric cancer|NN result|NN gastric inflammation|NN
shields|NP warren|NP willam|NP
describe intestinal metaplasia|NN stomach|NN feature|NN chronic gastritis|NN see
