rosea|NN wikipedia|NN free encyclopedia|NN jump|NN navigation|NN jump|NN search|NN rosea|NN name|NN rosea|NN pityriasis rosea|NN back|NN infectious disease|NN symptom|NN single red|NN slightly scaly area|NN follow usual onset|NN year|NN old duration|NN month|NN cause|NN diagnostic method|NN base symptom|NN differential diagnosis|NN viral rash|NN nummular eczema|NN treatment|NN care|NN frequency|NN point|NN time|NN
rosea|NN type|NN skin|NN rash|NN begin single red|NN slightly scaly area|NN known herald|NN patch|NN follow day|NN week|NN later pink whole body|NN rash|NN typically last month|NN goe treatment|NN sometime fever|NN occur start|NN rash|NN present symptom|NN
cause|NN entirely clear believe relate human herpesvirus|NN human herpesvirus|NN appear contagious certain medication|NN result similar rash|NN diagnosis|NN base symptom|NN
evidence|NN specific treatment|NN limit people|NN affect point|NN time|NN occur age|NN condition|NN describe early content|NN
sign|NN symptom|NN cause|NN diagnosis|NN treatment|NN epidemiology|NN see reference|NN external link|NN
sign|NN symptom|NN rosea|NN torso|NN
symptom|NN condition|NN include
upper respiratory tract|NN infection|NN precede symptom|NN patient|NN single 2-|NN rarely oval red herald|NN patch|NN appear classically abdomen|NN occasionally herald|NN patch|NN occur hidden position|NN armpit|NN example|NN notice immediately
herald|NN patch|NN appear cluster|NN smaller oval spot|NN mistaken acne|NN
rarely become present|NN day|NN herald|NN patch|NN small mm|NN patche|NN pink red flaky oval-shap rash|NN appear torso|NN
numerous oval patche|NN generally spread widely chest|NN rib-line|NN characteristic|NN distribution|NN
small circular patche|NN appear back|NN neck|NN day|NN later case|NN inverse distribution|NN occur rash|NN mostly extremity|NN children|NN presentation|NN atypical inverse course|NN typically milder people|NN pr|NP mild severe symptomatic itch|NN
moderate itch|NN due skin|NN over-dryness|NN common especially soap|NN use cleanse affect area|NN
itch|NN non-specific worsen scratch
tend fade rash|NN develop usually last entire course|NN disease|NN rash|NN accompany low-grade fever|NN headache|NN nausea|NN fatigue|NN
cause|NN rosea|NN certain clinical presentation|NN immunologic|NN reaction|NN suggest viral infection|NN cause|NN
believe reactivation|NN herpe|NN viruse|NN cause|NN infant|NN diagnosis|NN herald|NN patch|NN rosea|NN start rest|NN lesion|NN initially mistaken fungal infection|NN
experience practitioner|NN make diagnosis|NN clinically diagnosis|NN doubt|NN test|NN perform rule|NN similar condition|NN lyme|NP disease|NN ringworm|NN psoriasis|NN eczema|NN drug|NN eruption|NN viral exanthem|NN clinical appearance|NN rosea|NN similar secondary syphilis|NN rapid plasma|NN test|NN perform clinical concern|NN syphilis|NN biopsy|NN lesion|NN show erythrocyte|NN dermal papillae|NN dyskeratotic cell|NN dermis|NN
set|NN validate diagnostic criteria|NN rosea|NN follow
patient|NN diagnose rosea|NN
occasion|NN clinical encounter|NN essential clinical feature|NN optional clinical feature|NN occasion|NN clinical encounter|NN relate rash|NN exclusional clinical feature|NN
essential clinical feature|NN follow
circular|NN oval lesion|NN lesion|NN peripheral collarette|NN scale|NN central clearance|NN lesion|NN
optional clinical feature|NN follow
proximal limb|NN distribution|NN lesion|NN distal mid-upper-arm|NN orientation|NN lesion|NN skin|NN cleavage|NN line|NN herald|NN patch|NN necessarily largest appear|NN day|NN eruption|NN lesion|NN history|NN patient|NN clinical observation|NN
exclusional clinical feature|NN follow
multiple small vesicle|NN centre|NN lesion|NN lesion|NN palmar|NN skin|NN surface|NN clinical serological evidence|NN secondary syphilis|NN
condition|NN usually resolve treatment|NN require oral topical steroid|NN use decrease|NN itch|NN provide relief|NN itch|NN improve appearance|NN rash|NN cause new skin|NN form|NN rash|NN subside take longer match surround skin|NN color|NN
scare|NN found associate rash scratch|NN avoid
possible scratch|NN make itch worse itch-scratch cycle|NN develop regular scratch|NN itch|NN scratch scratch itch
irritant soap|NN fragrance|NN hot water|NN wool|NN synthetic fabrics|NN avoid
lotion help|NN stop|NN prevent itch|NN helpful
direct sunlight|NN make lesion|NN resolve quickly principle|NN medical treatment|NN ultraviolet light|NN use hasten resolution|NN study|NN disagree decrease itch|NN uv therapy|NN beneficial week|NN eruption|NN
meta-analysis|NN conclude insufficient evidence|NN effectiveness|NN treatment|NN oral erythromycin|NN found effective treate rash|NN relieve itch|NN base early trial|NN later study|NN confirm result|NN
patient|NN condition|NN last matter|NN week|NN case|NN last longer month|NN
disease|NN resolve completely long-term effect|NN
percent|NN patient|NN recurrence|NN epidemiology|NN
overal prevalence|NN pr|NP united|NP states|NP estimate 013 men|NN 014|NN women|NN
commonly occur age|NN common spring|NN
pr|NP view contagious report|NN small epidemics|NN fraternity|NN house|NN military base|NN school|NN gym|NN see
circinata|NN localize form|NN rosea|NN affect axillae|NN groin|NN pityriasis|NN list|NN similarly name flaky skin|NN condition|NN list|NN cutaneous condition|NN
